
000000000000000000000000000000000000000000000000000000000000
000000000000000000000000000000000000000000000000000000000000
000000000000000000000000000000000000000000000000000000000000
000000000000000000000000000000000000000000000000000000000000
000000000000000000000000000000000000000000000000000000000000
000000000000000000000000000000000000000000000000000000000000
000000000000000000000000000000000000000000000000000000000000
000000000000000000000000111110101000000000000000000000000000
000000000000000000000011111111111000000000000000000000000000
000000000000000000000110000111110000000000000000000000000000
000000000000000000001100000011111000000010000000000000000000
000000000000000000001100000001110000001111100000000000000000
000000000000000000001100000000111100011111111000000000000000
000000000000000000001100000000111111111111111000000000000000
000000000000000000011100000000111111111111000000000000000000
000000000000000000111110000000011111111100000000000000000000
000000000000000001111111000000011111111110000000000000000000
000000000000000011111111110000001111111110000000000000000000
000000000000000111111111111000000111111111000000000000000000
000000000000001111111111111100000001111111000000000000000000
000000000000011111111110011000000000000111000000000000000000
000000000001111100111100001100000000000111000000100000000000
000000000011111000011100000100000000000011000001110000000000
000000000011111000011100011100000000000000000001111000000000
000000000011111100111111011110000000000000000000111000000000
000000000001111111111111111100000001000000000000011100000000
000000000000111111111111100000000111110000000000000000000000
000000000000011111111111100000000111110000000000000000000000
000000000000001111000110000000001111111000000000000000000000
000000000000000100000000000000001111111000001110100000000000
000000000000000000000000000000011101111110111111110000000000
000000000000000000000000000000111111111111111111110000000000
000000000000000000000000000001111111111111111111100000000000
000000000000000000001111000011111111111111111000000000000000
000000000000000000011111100011111111110000000000000000000000
000000000000000000111111000011111101000000000000000000000000
000000000000000011111110000000111100000000000000000000000000
000000000000001111111100000000111000000000000000000000000000
000000000000001111111100000000111000000000000000000000000000
000000000000011111111100000000111100000000000000000000000000
000000000000001111111110000000111100000000000000000000000000
000000000000001111111110000000111000000000000000000000000000
000000000000000000011111000000111000000000000000000000000000
000000000000000000011110000001110000000000000000000000000000
000000000000000000001100000011110000000000000000000000000000
000000000000000000000000000111100000000000000000000000000000
000000000000000000000000001111111000000000000000000000000000
000000000000000000000000001111111110000000000000000000000000
000000000000000000000000000111111110000000000000000000000000
000000000000000000000000000000000000000000000000000000000000
000000000000000000000000000000000000000000000000000000000000