
000000000000000000000000000000000000000000000000000000000000
000000000000000000000000000000000000000000000000000000000000
000000000000000000000000000000000000000000000000000000000000
000000000000000000000000000000000000000000000000000000000000
000000000000000000000000000000000000000000000000000000000000
000000000000000000000000000000100000000000000000000000000000
000000000000000000000000000001111000000000000000000000000000
000000000000000000000000000000111000000000000000000000000000
000000000000000000000001000000000000000000000000000000000000
000000000000000000000011100000000000000000000000000000000000
000000000000000000000001100000000000000011100000000000000000
000000000000000001100011100000000000000111110000000000000000
000000000000000001111011000000000000000111110000000000000000
000000000000000001111111000000000000001111111000000000000000
000000000000000001111100000000000000001111111000000000000000
000000000000000001110000000001000000000111111100000000000000
000000000000000011100000000111110000000000000000000000000000
000000000000000011000000000111111000000000000000000000000000
000000000000000111000000001110001000000000000000000000000000
000000000000000111000000001110000000000000000000000000000000
000000000000011111100000001100000000000000000000000000000000
000000000001111111110000000110000000000000000000000000000000
000000000011110011111000000100000000000000000001110000000000
000000000111110011111110000110000000000001110111111000000000
000000000011110011111111000110000000000001111111111000000000
000000000011111111111111111100000000000000111111111100000000
000000000001111111111111111100000010000000011111110000000000
000000000001111110001111111000000111000000001111000000000000
000000000001111100000111110000000011100000001111000000000000
000000000001111000000111100000000011110000001111100000000000
000000000001110000000111000000000001111000011111110000000000
000000000011100000000110000000000001111100011111110000000000
000000000011100000000110000011110111111111111111110000000000
000000000011100000000111101111111111111111111100000000000000
000000000001000000001111111111111111111000000000000000000000
000000000000000000011111111111111111100000000000000000000000
000000000000000000111111111111111111000000000000000000000000
000000000000000001111110000000001100000000000000000000000000
000000000000000011111000000000000000000000000000000000000000
000000000000000111110000000000000000000000111100000000000000
000000000000000111100000000000000000000000111110000000000000
000000000000000110000000000100000000000000011100000000000000
000000000000000000000000011111000000110000000000000000000000
000000000000000000000011110111000000110000000000000000000000
000000000000000000000110000001100000110000000000000000000000
000000000000000000000000000000100000000000000000000000000000
000000000000000000000000000001110000000000000000000000000000
000000000000000000000000000001110000000000000000000000000000
000000000000000000000000000001100000000000000000000000000000
000000000000000000000000000000000000000000000000000000000000
000000000000000000000000000000000000000000000000000000000000