
000000000000000000000000000000000000000000000000000000000000
000000000000000000000000000000000000000000000000000000000000
000000000000000000000000000000000000000000000000000000000000
000000000000000000000000000000000000000000000000000000000000
000000000000000000000000000000000000000000000000000000000000
000000000000000000000000000000000000000000000000000000000000
000000000000000000000000000000001000000000000000000000000000
000000000000000000000000011000001000000000000000000000000000
000000000000000000000000011110000000000000000000000000000000
000000000000000000000000001111000000000000000000000000000000
000000000000000000000000000111100000000001100000000000000000
000000000000000000000000000001110000000111111000000000000000
000000000000000000000000000000010000011111111000000000000000
000000000000000000000000000000011111111111111000000000000000
000000000000000011000000000000000111111100000000000000000000
000000000000000001100000000000000111111000000000000000000000
000000000000000011100001000000000011110000000000000000000000
000000000000000001111111110000000111100000000000000000000000
000000000000000111111111111000000000000000000000000000000000
000000000000011111111111111100000000000000000000000000000000
000000000001111111111100111110000000000000000000100000000000
000000000011111111111000011110000000000000000011110000000000
000000000011100001111000011110000000000011111111111000000000
000000000000000001111100111100000000000001111111111000000000
000000000000000000111111111100000000000000011111110000000000
000000000000000000111111110000000000000000001111000000000000
000000000000000000011111110000000001000000001110000000000000
000000000000000000001111000000000001000000001100000000000000
000000000000000000000010000000000000000000011000000000000000
000000000001000000000000000000000000000000111000000000000000
000000000011100000000000000000000000000001111100000000000000
000000000001100000000000000111100000000011111111110000000000
000000000001100000000000011111110000001111111111100000000000
000000000001110000111000011111111000111000000110000000000000
000000000000111000111000001111111111110000000000000000000000
000000000000111111111000000011111111100000000000000000000000
000000000000011111110000000001111111000000000000000000000000
000000000000011111111000000000111111000000000000000000000000
000000000000011111111000000000011111100000000000000000000000
000000000000011110011111000000001111101011111110000000000000
000000000000001100001111111000001111111111111110000000000000
000000000000000000001111111110000111111111111100000000000000
000000000000000000001111000000000011110000000000000000000000
000000000000000000011100000000000011100000000000000000000000
000000000000000000000000000000000111100000000000000000000000
000000000000000000000000000000000111100000000000000000000000
000000000000000000000000000000001111100000000000000000000000
000000000000000000000000000000001111100000000000000000000000
000000000000000000000000000000000010000000000000000000000000
000000000000000000000000000000000000000000000000000000000000
000000000000000000000000000000000000000000000000000000000000