
000000000000000000000000000000000000000000000000000000000000
000000000000000000000000000000000000000000000000000000000000
000000000000000000000000000000000000000000000000000000000000
000000000000000000000000000000000000000000000000000000000000
000000000000000000000000000000000000000000000000000000000000
000000000000000000000000000000000000000000000000000000000000
000000000000000000000000000000001000000000000000000000000000
000000000000000000000000000000000000000000000000000000000000
000000000000000000000010000000000000000000000000000000000000
000000000000000000001110000000000000000000000000000000000000
000000000000000000011100000000000000000001000000000000000000
000000000000000001111000000000000000000000000000000000000000
000000000000000011110000000000000000000000000000000000000000
000000000000000011100000000000000001000000000000000000000000
000000000000000111000000000000000111110000000000000000000000
000000000000000110000000000000001111110000000000000000000000
000000000000000110000000000000011111110000000000000000000000
000000000000000110000000010000001111100000000000000000000000
000000000000011111000001111000001110000000000000000000000000
000000000000011111111111111000000000000000000000000000000000
000000000001111111111111111000000000000000000000000000000000
000000000001111111111111111100000000000000000000000000000000
000000000011111111111000111111000000000000000110000000000000
000000000011111111100000011111100000000000000110000000000000
000000000011111111000000011111100000000000001100000000000000
000000000001111110000000011111000000000000001100000000000000
000000000001111100000000111110000001000000011100000000000000
000000000001111000000001110000000001000000011100000000000000
000000000001110000000011110000000000000000011100000000000000
000000000011100000000111000000000000000000111110000000000000
000000000011100000001111000000000000000001111111110000000000
000000000011100000011110000000000000001111111111110000000000
000000000011110000111100000001000000111111111111100000000000
000000000001110000011100000111111111111111111110000000000000
000000000000111000011000001111111111110000001000000000000000
000000000000011000000000011111111111000000000000000000000000
000000000000001100000000011111111100000000000000000000000000
000000000000001110000000111111111000000000000000000000000000
000000000000001111000000111111110000000000000000000000000000
000000000000001111111111111111100000000000000000000000000000
000000000000001111111111111111000000000000000000000000000000
000000000000000100011111000111000001100000000000000000000000
000000000000000000001111000011000000100000000000000000000000
000000000000000000001100000011000000000000000000000000000000
000000000000000000000100000011100000000000000000000000000000
000000000000000000000000000011100000000000000000000000000000
000000000000000000000000000011110000000000000000000000000000
000000000000000000000000000111110000000000000000000000000000
000000000000000000000000000011110000000000000000000000000000
000000000000000000000000000000000000000000000000000000000000
000000000000000000000000000000000000000000000000000000000000