
000000000000000000000000000000000000000000000000000000000000
000000000000000000000000000000000000000000000000000000000000
000000000000000000000000000000000000000000000000000000000000
000000000000000000000000000000000000000000000000000000000000
000000000000000000000000000000000000000000000000000000000000
000000000000000000000000000000100000000000000000000000000000
000000000000000000000000001111110000000000000000000000000000
000000000000000000000000011111110000000000000000000000000000
000000000000000000000000011110000000000000000000000000000000
000000000000000000000000001000000000000000000000000000000000
000000000000000000000000000000000000000011000000000000000000
000000000000000000000000000000000000000111000000000000000000
000000000000000000111000000000000000001110000000000000000000
000000000000000001111000000000000111111110000000000000000000
000000000000000001111100000000001111111100000000000000000000
000000000000000001111110000000011111111100000000000000000000
000000000000000001111111111000001111111100000000000000000000
000000000000000011111111111100000111111100000000000000000000
000000000000000111111111111100000001111110000000000000000000
000000000000001111111111111100000000111110000000000000000000
000000000000111111111111111100000000011111000001100000000000
000000000011111111111100111110000000001111000011100000000000
000000000011000011111000001111000000000111110111100000000000
000000000000000001111000011111000000000011111111100000000000
000000000000000001111100011110000000000001111111100000000000
000000000000000011111111111100000000000000111111100000000000
000000000000000111111111111000000000000000011111100000000000
000000000000001101011111110000000000000000001111000000000000
000000000000111100000111100000000000000000000111100000000000
000000000001110000000111000000000000000000000111000000000000
000000000001100000000111000000000000110000001111000000000000
000000000000000000000111000011100001110000011111000000000000
000000000000000000001110001111111011100000011110000000000000
000000000000000000001111101111111111100000011110000000000000
000000000000000000011111111111111111000000011100000000000000
000000000000000000001111110111111111000000001100000000000000
000000000000011000001110000001111110000000011100000000000000
000000000000011000000000000000111110000000001100000000000000
000000000000001100000000000000011111000000011100000000000000
000000000000011100000000000000001111100000111100000000000000
000000000000001100000000000000001111111111111100000000000000
000000000000001110000000000000000011111111111000000000000000
000000000000000100000000000000000000100000000000000000000000
000000000000000000000000000000100000000000000000000000000000
000000000000000000000000000011111000000000000000000000000000
000000000000000000000110000111111000000000000000000000000000
000000000000000000000000000111111110000000000000000000000000
000000000000000000000000000111111111000000000000000000000000
000000000000000000000000000011111110000000000000000000000000
000000000000000000000000000000000000000000000000000000000000
000000000000000000000000000000000000000000000000000000000000