
000000000000000000000000000000000000000000000000000000000000
000000000000000000000000000000000000000000000000000000000000
000000000000000000000000000000000000000000000000000000000000
000000000000000000000000000000000000000000000000000000000000
000000000000000000000000000000000000000000000000000000000000
000000000000000000000000000000000000000000000000000000000000
000000000000000000000000000000000000000000000000000000000000
000000000000000000000000111100000000000000000000000000000000
000000000000000000000011111110000000000000000000000000000000
000000000000000000000011001111000000000000000000000000000000
000000000000000000000110000011000000000000000000000000000000
000000000000000000000110000011100000000110000000000000000000
000000000000000000001110000000000000001100000000000000000000
000000000000000000011110000000000000011110000000000000000000
000000000000000000111111000000000000111100000000000000000000
000000000000000001111111100000000001111110000000000000000000
000000000000011111111111110000000111111111000000000000000000
000000000000111111010111100000000111111111000000000000000000
000000000000111100000000000000000001111111000000000000000000
000000000001110000000000000000000000111111000000000000000000
000000000001100000000000000000000000011100000000000000000000
000000000011000000000000000000000000000000000000000000000000
000000000011000000000100001110000000000000000000000000000000
000000000111100000001111011111100000000000000111110000000000
000000000011110000000111111111110000000000001111111000000000
000000000011111100000111111111111000000000001111110000000000
000000000001111110000000000001111110000000001111110000000000
000000000001111110000000000001111111100000001111100000000000
000000000001111100000000000000111111110000000111110000000000
000000000011111100000000000011111111110000000111110000000000
000000000011111000000000000011111111110000000111111000000000
000000000011111000001100000111111111110000001111111000000000
000000000001110000011000001111110001110000011111110000000000
000000000001111000011000000111111011100000011110000000000000
000000000000110000010000000111111111100000001000000000000000
000000000000110000110000000011111111000000000000000000000000
000000000000000000100000000011111111000000000000000000000000
000000000000000000000000000000111111000000000000000000000000
000000000000000011000000000000111111000000000000000000000000
000000000000000110000000000000001111110100000000000000000000
000000000000000110000000000000000011000100000000000000000000
000000000000000110000011000000000000000000000000000000000000
000000000000000000000000000000000000000000000000000000000000
000000000000000000000000000000000000000000000000000000000000
000000000000000000000000000001111000000000000000000000000000
000000000000000000000000000001111110000000000000000000000000
000000000000000000000000000000111111000000000000000000000000
000000000000000000000000000000011111000000000000000000000000
000000000000000000000000000000000100000000000000000000000000
000000000000000000000000000000000000000000000000000000000000
000000000000000000000000000000000000000000000000000000000000