
000000000000000000000000000000000000000000000000000000000000
000000000000000000000000000000000000000000000000000000000000
000000000000000000000000000000000000000000000000000000000000
000000000000000000000000000000000000000000000000000000000000
000000000000000000000000000000000000000000000000000000000000
000000000000000000000000000000000000000000000000000000000000
000000000000000000000000001111100000000000000000000000000000
000000000000000000000000111111100000000000000000000000000000
000000000000000000000000111111100000000000000000000000000000
000000000000000000000000000010000000000000000000000000000000
000000000000000000000000000000000000000000000000000000000000
000000000000000000100000000000000000000000010000000000000000
000000000000000001111000000000000000000000011100000000000000
000000000000000000111000000000000111110000000100000000000000
000000000000000000111100000000011111111100000000000000000000
000000000000000000011110000000011111111100000000000000000000
000000000000000000111111000000011111111110000000000000000000
000000000000000000011111100000001111111100000000000000000000
000000000000000000111111110000000111111100000000000000000000
000000000000000000111110111000000001111000000000000000000000
000000000000000001111100011100000000010000000000000000000000
000000000010000001111110111110000000000000000000000000000000
000000000011000001111111111111000000000000000111110000000000
000000000011100011111111111111100000000000011111111000000000
000000000011111111111111111111110000000000011111111100000000
000000000011111111111111111111110000000000011111001100000000
000000000011111111001111111001111000000000001110000000000000
000000000011111110001111110000111000000000001110000000000000
000000000011111000000111110000111100000000001111000000000000
000000000111111000001111111001111000000000001111100000000000
000000000011100000001111111111100000000000111111111000000000
000000000011100000011111111110000000000111111111111000000000
000000000000100000011111111000000000000111111111100000000000
000000000000100000011110000000000000000001000000000000000000
000000000000111000001000000000000000000000000000000000000000
000000000000011000000000000000001000000000000000000000000000
000000000000011110000000000000011110000000000000000000000000
000000000000001110000000000000111111000000000000000000000000
000000000000001111100000000000111111101000000000000000000000
000000000000001111111000000001111111111110000000000000000000
000000000000000101011111111111111111111100000000000000000000
000000000000000000011111111111110111111100000000000000000000
000000000000000000001111111110000001110000000000000000000000
000000000000000000001111000000000000000000000000000000000000
000000000000000000011100000000000000000000000000000000000000
000000000000000000000000000000000000000000000000000000000000
000000000000000000000000000000000000000000000000000000000000
000000000000000000000000000000000000100000000000000000000000
000000000000000000000000000000000000000000000000000000000000
000000000000000000000000000000000000000000000000000000000000
000000000000000000000000000000000000000000000000000000000000