
000000000000000000000000000000000000000000000000000000000000
000000000000000000000000000000000000000000000000000000000000
000000000000000000000000000000000000000000000000000000000000
000000000000000000000000000000000000000000000000000000000000
000000000000000000000000000000000000000000000000000000000000
000000000000000000000000000000000000000000000000000000000000
000000000000000000000000000000001000000000000000000000000000
000000000000000000000000011000000000100000000000000000000000
000000000000000000000000011110000000111000000000000000000000
000000000000000000000000001110000000111100000000000000000000
000000000000000000000000000111000000011100000000000000000000
000000000000000000100000000011100000011000000000000000000000
000000000000000011111000000000000000011000000000000000000000
000000000000000111111000000000000000111000000000000000000000
000000000000001111111100000000000000111000000000000000000000
000000000000001111011110000000000011111000000000000000000000
000000000000001100001111000000000011111100000000000000000000
000000000000000000001111100000000111111110000001100000000000
000000000000000000001111111000000011111111000001100000000000
000000000000000000011111111100000000111110000001100000000000
000000000000000000011101111110000000011111000011110000000000
000000000011100000011101111110000000001110000111110000000000
000000000011110000011111111111000000000011101111111000000000
000000000011110000001111111111100000000000111111111000000000
000000000011111000001111111111110000000000111111111000000000
000000000011111000001111110011111100000000011110000000000000
000000000011111100001111100001111110000000011100000000000000
000000000011111110011111000001111110000000011110000000000000
000000000011111111111110000011100000000000011111000000000000
000000000000001111111110000111000000000000111111100000000000
000000000000000111111100001111000000000000111111110000000000
000000000000000011111100001111000000000000000001110000000000
000000000000000000111000011111100000000000000000010000000000
000000000000000000000000001111111010100000000000000000000000
000000000000000000000000000111111111100000000000000000000000
000000000000110000000000000011111111000000000000000000000000
000000000000111000000000000001111111000000000000000000000000
000000000000111000000000000001111111000000000000000000000000
000000000000011000000000000011111111100000001000000000000000
000000000000011000001111111111111111110000011110000000000000
000000000000001100001111111111111111111000001110000000000000
000000000000001000111111111111110111110000000100000000000000
000000000000000010111110000111100111110000000000000000000000
000000000000000011111000000011100011100000000000000000000000
000000000000000000100000000011100011100000000000000000000000
000000000000000000000000000111111011100000000000000000000000
000000000000000000000000001111111011100000000000000000000000
000000000000000000000000001111100000000000000000000000000000
000000000000000000000000001110000000000000000000000000000000
000000000000000000000000000000000000000000000000000000000000
000000000000000000000000000000000000000000000000000000000000