
000000000000000000000000000000000000000000000000000000000000
000000000000000000000000000000000000000000000000000000000000
000000000000000000000000000000000000000000000000000000000000
000000000000000000000000000000000000000000000000000000000000
000000000000000000000000000000000000000000000000000000000000
000000000000000000000000000000000000000000000000000000000000
000000000000000000000000000000100000000000000000000000000000
000000000000000000000000000011110000000000000000000000000000
000000000000000000000001011111100000000000000000000000000000
000000000000000000001111111111100000000000000000000000000000
000000000000000000001111111111000000000011100000000000000000
000000000000000000001111110000000000000011100000000000000000
000000000000000000000111100000000000000011110000000000000000
000000000000000000001111000000001100000111100000000000000000
000000000000000000001111000000001111001111000000000000000000
000000000000000000011111000000001111111110000000000000000000
000000000000000000111111000000000111111110000000000000000000
000000000000000001111111100000000111111110000000000000000000
000000000000000011111111110000000011111111000000000000000000
000000000000001111111111111000000001111111100000000000000000
000000000000111111111111111100000000111111100000000000000000
000000000000111111111111111110000000001111110000000000000000
000000000001110011111110001110000000001111111000000000000000
000000000011100011111110001111000000000011111111000000000000
000000000011110001111110001111000000000011111111110000000000
000000000011110111111110000110000000000000111111111000000000
000000000111111111111110000000000000000000011111111000000000
000000000011111111111110000000000000000000000111111000000000
000000000011111111101111000000001100000000000111110000000000
000000000011111111000011100000011000000000000011110000000000
000000000011111111000011110000111000001000000011110000000000
000000000011111011000000111111110000011000000111110000000000
000000000011110000000000011111100000011000000111110000000000
000000000011110000000000001111100000010000001111100000000000
000000000001111000000000000111110000110000001111000000000000
000000000001111100000000000111111111110000001110000000000000
000000000000111110000000000001111111100000001110000000000000
000000000000011111000000000000111111110000001100000000000000
000000000000001111100000000000011111100000001110000000000000
000000000000000111110000000000011111110000001100000000000000
000000000000000001111110000000011111111000111110000000000000
000000000000000000011111000000011111111110111100000000000000
000000000000000000000111100000011101111111101000000000000000
000000000000000000000011100000111100011110000000000000000000
000000000000000000000011000000110000000000000000000000000000
000000000000000000000011000000100000000000000000000000000000
000000000000000000000000000000000000000000000000000000000000
000000000000000000000000000000000000000000000000000000000000
000000000000000000000000000000000000000000000000000000000000
000000000000000000000000000000000000000000000000000000000000
000000000000000000000000000000000000000000000000000000000000