
000000000000000000000000000000000000000000000000000000000000
000000000000000000000000000000000000000000000000000000000000
000000000000000000000000000000000000000000000000000000000000
000000000000000000000000000000000000000000000000000000000000
000000000000000000000000000000000000000000000000000000000000
000000000000000000000000000000100000000000000000000000000000
000000000000000000000000001111111000000000000000000000000000
000000000000000000000000111111110000000000000000000000000000
000000000000000000000001111111100000000000000000000000000000
000000000000000000000000011111000000000010000000000000000000
000000000000000000000000000111100000001111000000000000000000
000000000000000000000000000011100000111111000000000000000000
000000000000000000110000000001111010111100000000000000000000
000000000000000001111000000000111111111100000000000000000000
000000000000000011111110000000011111110000000000000000000000
000000000000001111111111100000011111111000000000000000000000
000000000000011111111111100000000111111000000000000000000000
000000000000111111100001000000000011111100000000000000000000
000000000000111111000000000000000001111110000000000000000000
000000000001111100000000000000000000111111000001110000000000
000000000001110000000000000000000000001111100011110000000000
000000000011100000000000000000000000000111111111110000000000
000000000011000000000000011110000000000011111111111000000000
000000000111000000000000111111100000000001111111111000000000
000000000011100000110101111111110000000001111110001000000000
000000000011111111111111111111111100000000111110000000000000
000000000001111111111111110011111100000000111110000000000000
000000000000111111111111100001111111000000011110000000000000
000000000000111100001111000001111111000000001111000000000000
000000000001111000000000000001111111100000000111100000000000
000000000011110000000000000001111111110000000111110000000000
000000000011110000000000000001111011110000000111110000000000
000000000011110000000000000001111011111000001111100000000000
000000000011111000000000000001111111110000011111000000000000
000000000001111100000000000001111111110000001100000000000000
000000000001111111110000000001111111100000000000000000000000
000000000000111111111000000001111111000000000000000000000000
000000000000011111111000000000111110000000000000000000000000
000000000000001111111000000000111110000000000000000000000000
000000000000000111111100000000001111000000000000000000000000
000000000000000001111111000000001111111000000000000000000000
000000000000000000011111100000000011111000000000000000000000
000000000000000000001111100000000000100000000000000000000000
000000000000000000000111100000000000000000000000000000000000
000000000000000000000111000000000000000000000000000000000000
000000000000000000000000000000000000000000000000000000000000
000000000000000000000000000111110000000000000000000000000000
000000000000000000000000001111111000000000000000000000000000
000000000000000000000000000110101010000000000000000000000000
000000000000000000000000000000000000000000000000000000000000
000000000000000000000000000000000000000000000000000000000000