
000000000000000000000000000000000000000000000000000000000000
000000000000000000000000000000000000000000000000000000000000
000000000000000000000000000000000000000000000000000000000000
000000000000000000000000000000000000000000000000000000000000
000000000000000000000000000000000000000000000000000000000000
000000000000000000000000000000000000000000000000000000000000
000000000000000000000000000000001000000000000000000000000000
000000000000000000000000000000000110000000000000000000000000
000000000000000000000000000000000001110000000000000000000000
000000000000000000000000000000000000111100000000000000000000
000000000000000000000000000000000000011100000000000000000000
000000000000000001111000000000000000001110000000000000000000
000000000000000011111100000000000000001110000000000000000000
000000000000000011111000000000000000000110000000000000000000
000000000000000001110000000000000000000000000000000000000000
000000000000000011110000000000000000000000000000000000000000
000000000000000000000000110000000110000000000000000000000000
000000000000000000001011110000000100000000000000000000000000
000000000000000000001111100000000000000010000000000000000000
000000000000000000001111000000000000000111000000000000000000
000000000000000000001110000000000000001111100000000000000000
000000000011100000001100000000000000001111100000000000000000
000000000011110000001100000000000000001111100000110000000000
000000000011100000011110000111100000000011000000111000000000
000000000000000000111111111111100000000000000000111000000000
000000000000000001111111111111110000000000000000011100000000
000000000000000011111111111111111000000000000000000000000000
000000000000001111111111110000111111000000000000000000000000
000000000000111111111111100000011111100000000000000000000000
000000000011111111111111000000011111100000000000000000000000
000000000011101111111110000000011111100000011111100000000000
000000000011100001111000000000111111100000111111110000000000
000000000011000000000000000001110111000000111111110000000000
000000000001100000000000000011110000000000111111100000000000
000000000001110000000000000111000000000000011111100000000000
000000000000111000000000000111000000000000001110000000000000
000000000000111110000000011110000000000000001110000000000000
000000000000011111111111111100000111000000011110000000000000
000000000000001111111111111100001111100000111110000000000000
000000000000000111111111111110011111111111111111000000000000
000000000000001111001111111111111111111111111110000000000000
000000000000000110000111111111111111111111111000000000000000
000000000000000100000111100111111111100000000000000000000000
000000000000000000001111000011111100000000000000000000000000
000000000000000000011110000001111000000000000000000000000000
000000000000000000001110000000111000000000000000000000000000
000000000000000000000000000000001000000000000000000000000000
000000000000000000000000000000000000000000000000000000000000
000000000000000000000000000000000000000000000000000000000000
000000000000000000000000000000000000000000000000000000000000
000000000000000000000000000000000000000000000000000000000000