
000000000000000000000000000000000000000000000000000000000000
000000000000000000000000000000000000000000000000000000000000
000000000000000000000000000000000000000000000000000000000000
000000000000000000000000000000000000000000000000000000000000
000000000000000000000000000000000000000000000000000000000000
000000000000000000000000000000100000000000000000000000000000
000000000000000000000000001111111000000000000000000000000000
000000000000000000000000111111111000000000000000000000000000
000000000000000000000001111111111000000000000000000000000000
000000000000000000000000011111100000000010000000000000000000
000000000000000000000000000110000000000111000000000000000000
000000000000000000000000000000000000001111000000000000000000
000000000000000001110000000000000000001111000000000000000000
000000000000000011111100000000000000001110000000000000000000
000000000000000011111110000000001110111110000000000000000000
000000000000001111111100000000011111111100000000000000000000
000000000000011111110000000000001111111110000000000000000000
000000000000011111100000000000001111111110000000000000000000
000000000000111111000000000000000111111111000000000000000000
000000000000011111000000000000000000001111100000000000000000
000000000000111110000000000000000000000111100000000000000000
000000000000011110000001110100000000000011110000110000000000
000000000000111100000001111110000000000001110000110000000000
000000000000111100000011111110000000000001100001111000000000
000000000001111100000111111100000000000000000001111000000000
000000000011111111001111111000000000000000000001111000000000
000000000111111111111111111000000000000000000001110000000000
000000000111111111111111111000000011000000000011110000000000
000000000111111111101011111000000011100000000111110000000000
000000000111111111000001111100000001110000001111110000000000
000000000011111110000000111100000001111000011111110000000000
000000000011111100000000011111000001111100111111111000000000
000000000011111000000000001111100011111111111111110000000000
000000000001111000000000001111111111111111110000000000000000
000000000001111000000000000111111111111111000000000000000000
000000000000111000000000000011111111110000000000000000000000
000000000000010000001000000000111110000000000000000000000000
000000000000000000011000000000111110000000000000000000000000
000000000000000000000000000000011000000000000000000000000000
000000000000000000000000000101111000000000000000000000000000
000000000000000000000000011111110000000000011100000000000000
000000000000000000000001111111110000000000011100000000000000
000000000000000110000011111111110000000000000000000000000000
000000000000000010000111111111110000000000000000000000000000
000000000000000000001111000001110000000000000000000000000000
000000000000000000001100000001111100000000000000000000000000
000000000000000000000000000000111100000000000000000000000000
000000000000000000000000000000111100000000000000000000000000
000000000000000000000000000000011000000000000000000000000000
000000000000000000000000000000000000000000000000000000000000
000000000000000000000000000000000000000000000000000000000000