
000000000000000000000000000000000000000000000000000000000000
000000000000000000000000000000000000000000000000000000000000
000000000000000000000000000000000000000000000000000000000000
000000000000000000000000000000000000000000000000000000000000
000000000000000000000000000000000000000000000000000000000000
000000000000000000000000000000000000000000000000000000000000
000000000000000000000000001111000000000000000000000000000000
000000000000000000000000111111000000000000000000000000000000
000000000000000000000011111100000000001000000000000000000000
000000000000000000001110000000000000011100000000000000000000
000000000000000000011100000000000000001100000000000000000000
000000000000000000111100000000000000000000000000000000000000
000000000000000001111100000000000000000000000000000000000000
000000000000000011111100000000110000000000000000000000000000
000000000000000111111110000000111000000000000000000000000000
000000000000001111111110000011111000000000000000000000000000
000000000000011111011111101001111100000000000000000000000000
000000000000011100001111111110111111111111000000000000000000
000000000000011110001111111000011111111111100000000000000000
000000000000011110111110100000001100001111100000000000000000
000000000000001111111110000000000000000111100000000000000000
000000000000000111111100000000000000000111000000110000000000
000000000000000111111100000000000000000011000001110000000000
000000000000000011111110000000000000000000000011111000000000
000000000000000111111111000000000000000000000011111000000000
000000000000000011001111100000000000000000000111101100000000
000000000000000110000111110000000011000000000110001000000000
000000000000001110001111110000000011000000001110000000000000
000000000000011100001111110000000011000000001110000000000000
000000000001111100011111111000000000000000011111000000000000
000000000011111000001111111110000000000000011111111000000000
000000000011110000001111111111100000000000111111111000000000
000000000011111000001110011111100000000000111111111000000000
000000000011110000011100001111111000000000011111100000000000
000000000000111100111100000111111111000000000000000000000000
000000000000011111111100000011111111000000000000000000000000
000000000000001111111000000001111111000000000000000000000000
000000000000001111111000000000111110000000000000000000000000
000000000000001111100000000000111100000111111100000000000000
000000000000001110000000000000111000000011111110000000000000
000000000000000000000000000001111000000000000110000000000000
000000000000000000000000000001110000000000000000000000000000
000000000000000000000000000011111000000000000000000000000000
000000000000000000000000000011111000000000000000000000000000
000000000000000000010000000111111110000000000000000000000000
000000000000000000000000000111111111000000000000000000000000
000000000000000000000000000111111111100000000000000000000000
000000000000000000000000000011111111000000000000000000000000
000000000000000000000000000000000000000000000000000000000000
000000000000000000000000000000000000000000000000000000000000
000000000000000000000000000000000000000000000000000000000000