
000000000000000000000000000000000000000000000000000000000000
000000000000000000000000000000000000000000000000000000000000
000000000000000000000000000000000000000000000000000000000000
000000000000000000000000000000000000000000000000000000000000
000000000000000000000000000000000000000000000000000000000000
000000000000000000000000000000100000000000000000000000000000
000000000000000000000000001111111000000000000000000000000000
000000000000000000000000111111111000000000000000000000000000
000000000000000000000011111111110000000000000000000000000000
000000000000000000001111110000000000000110000000000000000000
000000000000000000011111000000000000001111100000000000000000
000000000000000001111100000000000000011111100000000000000000
000000000000000011111000000000000000111111111000000000000000
000000000000000111100000000000000001111111111000000000000000
000000000000000111100000000000000111100000001000000000000000
000000000000001111000000000000001111100000000000000000000000
000000000000011111000000000000011110000000000000000000000000
000000000000111111000001100000001000000000000000000000000000
000000000000111111000000000000000000000000000000000000000000
000000000001111111100000000000000000000011110000000000000000
000000000001111111110000000000000000000111100000000000000000
000000000000000001111000000000000000001111111010000000000000
000000000000000000111100000001000000001111111111100000000000
000000000000000000011110000111110000000011111111110000000000
000000000000000100001111111111111000000000111111111000000000
000000000000011110001111111111111100000000001111111000000000
000000000000111100000111111100111110000000000000000000000000
000000000001111100000111111000011111000000000000000000000000
000000000011111000000011110000001111000000000000000000000000
000000000011111000000011110000000111100000000111000000000000
000000000011110000000001110000000011100000001111100000000000
000000000011110000000001110000000011110000011111000000000000
000000000001110000000000111000000011110000001111000000000000
000000000001110000000000010000000111100000011110000000000000
000000000000100000000000000000001111100000001100000000000000
000000000000000000110000000000001111000000011100000000000000
000000000000000001110000000000011111000000111100000000000000
000000000000000011110000000000011111100001111100000000000000
000000000000000111100000000000111111101011111100000000000000
000000000000001111100000000001111111111111111110000000000000
000000000000001111000000011111111111111111111110000000000000
000000000000001111000001111111110011111000000100000000000000
000000000000000100000011111111100001110000000000000000000000
000000000000000000000111111111000001110000000000000000000000
000000000000000000000110001110000011110000000000000000000000
000000000000000000000000000110000111110000000000000000000000
000000000000000000000000000110001111110000000000000000000000
000000000000000000000000000111111111100000000000000000000000
000000000000000000000000000011101110000000000000000000000000
000000000000000000000000000000000000000000000000000000000000
000000000000000000000000000000000000000000000000000000000000