
000000000000000000000000000000000000000000000000000000000000
000000000000000000000000000000000000000000000000000000000000
000000000000000000000000000000000000000000000000000000000000
000000000000000000000000000000000000000000000000000000000000
000000000000000000000000000000000000000000000000000000000000
000000000000000000000000000000100000000000000000000000000000
000000000000000000000000000011111000000000000000000000000000
000000000000000000000000000011111000000000000000000000000000
000000000000000000000000000000000000000000000000000000000000
000000000000000000000000000000000000000100000000000000000000
000000000000000000000000000000000000001110000000000000000000
000000000000000000000000000000000000011100000000000000000000
000000000000000000000110000000000000111100000000000000000000
000000000000000000001110000000001111110000000000000000000000
000000000000000000000111000000011111100000000000000000000000
000000000000000000000111100000001111000000000000000000000000
000000000000000000000111100000000100000000000000000000000000
000000000000011110000011000000000000000000000000000000000000
000000000000001111001010000000000000000111000000000000000000
000000000000111111100000000000000000001111100000110000000000
000000000000111111111000000000000000001111000000110000000000
000000000011111111100000001000000000011111000000110000000000
000000000011111111100000111110000000001110000001111000000000
000000000111111111000001111111100000000000000011111000000000
000000000111111111000001111111111110000000000011111000000000
000000000011111110000011110001111110000000000111110000000000
000000000000011110000011100000111100000000000111110000000000
000000000000001100000011000000111000000000001111100000000000
000000000000000110000111000001110000000000000111110000000000
000000000000000111001110000011100000000000001111110000000000
000000000110000011111110000011100000000000001111111000000000
000000000111000011111100000111100000000001111111110000000000
000000000011100001111100000111110000010111111111110000000000
000000000011110001111000001111111111111101111111000000000000
000000000001111111110000001111111111100000011100000000000000
000000000001111111110000000111111111000000000000000000000000
000000000000111111000000000011111110000000000000000000000000
000000000000011111000000000000111100000000000000000000000000
000000000000001100000000000000011100000000000000000000000000
000000000000000000000000000000001110000000000110000000000000
000000000000000000000110000000000111111100000010000000000000
000000000000000000001111000000000011111000000000000000000000
000000000000000000011110000000000001111000000000000000000000
000000000000000000011110000000000001111000000000000000000000
000000000000000000011100000001110011110000000000000000000000
000000000000000000001000000001111111111000000000000000000000
000000000000000000000000000001111111110000000000000000000000
000000000000000000000000000000111111100000000000000000000000
000000000000000000000000000000011110000000000000000000000000
000000000000000000000000000000000000000000000000000000000000
000000000000000000000000000000000000000000000000000000000000