
000000000000000000000000000000000000000000000000000000000000
000000000000000000000000000000000000000000000000000000000000
000000000000000000000000000000000000000000000000000000000000
000000000000000000000000000000000000000000000000000000000000
000000000000000000000000000000000000000000000000000000000000
000000000000000000000000000000000000000000000000000000000000
000000000000000000000000000000001000000000000000000000000000
000000000000000000000000111010111100000000000000000000000000
000000000000000000000001111110101000000000000000000000000000
000000000000000000000001111000000000000000000000000000000000
000000000000000000000000000000000000000011100000000000000000
000000000000000000000000000000000000000011100000000000000000
000000000000000000000000000000000000000111100000000000000000
000000000000000001110000000000000000000111100000000000000000
000000000000000011111000000000001000001111000000000000000000
000000000000001111110000000000001000000111000000000000000000
000000000000011111110000000000000100000110000000000000000000
000000000000011111100000000000000100000111000000000000000000
000000000000011111100000110000000110000110000000000000000000
000000000000011111000011110000000000000111000000000000000000
000000000000111110000111100000000000000011000000000000000000
000000000001111100001111100000000000000011100000000000000000
000000000001111000011110000000000000000001100000110000000000
000000000011110000111110000001110000000001110000000000000000
000000000011111001111000000001111000000000100000000000000000
000000000011111111111000000001111100000000000000000000000000
000000000001111111110000000000111110000000000000000000000000
000000000001111111110000000000111111000000000000000000000000
000000000000111111000000000000111111100000000000000000000000
000000000000111100000000110001111111110000000000000000000000
000000000000111100000011111111111111110000000110000000000000
000000000001110000000011111111111111111000011110000000000000
000000000001110000000111111111100011110000011100000000000000
000000000001000000000111111110000001110000011000000000000000
000000000000000000000111100000000001100000000000000000000000
000000000000000000001111000000000011100000000000000000000000
000000000000000000011111000000000111100000000000000000000000
000000000000000111111110000000001111100000000000000000000000
000000000000001111111111000000001111100000000000000000000000
000000000000001111111110000000011111100000011000000000000000
000000000000001111111111000000011111100000111100000000000000
000000000000001111100111000000111111000000011100000000000000
000000000000000111000011100000111110000000000000000000000000
000000000000000010000011100000111100000000000000000000000000
000000000000000000000011000000111000000000000000000000000000
000000000000000000000000000001111000000000000000000000000000
000000000000000000000000000011111000000000000000000000000000
000000000000000000000000000011110000000000000000000000000000
000000000000000000000000000001100000000000000000000000000000
000000000000000000000000000000000000000000000000000000000000
000000000000000000000000000000000000000000000000000000000000