
000000000000000000000000000000000000000000000000000000000000
000000000000000000000000000000000000000000000000000000000000
000000000000000000000000000000000000000000000000000000000000
000000000000000000000000000000000000000000000000000000000000
000000000000000000000000000000000000000000000000000000000000
000000000000000000000000000000000000000000000000000000000000
000000000000000000000000001111111000000000000000000000000000
000000000000000000000000111111111110000000000000000000000000
000000000000000000000001111100000001010000000000000000000000
000000000000000000000011111000000000011100000000000000000000
000000000000000000000011100000000000011100000000000000000000
000000000000000000000011100000000000001100000000000000000000
000000000000000000000111000000000000001100000000000000000000
000000000000000000000110000000000000011100000000000000000000
000000000000000000011110000000000000111000000000000000000000
000000000000000000011100000000000001111000000000000000000000
000000000000000001111000000111111111110000000000000000000000
000000000000000001111000000111111111000000000000000000000000
000000000000000011100000000000001100000000000000000000000000
000000000000000111100000000000000000000000000000000000000000
000000000000001110000000000000000000000001111000000000000000
000000000001111110000000000000000000000111111000000000000000
000000000011111100000000000010000000001111111111000000000000
000000000111111100000000001111100000000111111111000000000000
000000000011111100000000111111110000000001111110000000000000
000000000011111110000001111111100000000000111110000000000000
000000000001111111000001111111110000000000011110000000000000
000000000000111111000011110101000000000000001110000000000000
000000000000011111110111100000100000000000001110000000000000
000000000000001111111111000000000000000000001110000000000000
000000000000000111111110000001110000000000011110000000000000
000000000000000001111110000001110000000000111110000000000000
000000000000000001111110000111111000000001111110000000000000
000000000000000000011110000111111000000011111110000000000000
000000000000000000011110000111111100001111111100000000000000
000000000000000000001110000011111111111000000000000000000000
000000000000000000000110000001111111100000000000000000000000
000000000000000000000000000000111110000000000000000000000000
000000000000000100000000000000111100000000000000000000000000
000000000000001110000000000001111000000000011000000000000000
000000000000001111000000000111110000000000011100000000000000
000000000000001111000000011111110000000000001100000000000000
000000000000000111000001111111110000000000000000000000000000
000000000000000010000001111111110000000000000000000000000000
000000000000000000000111110011111000000000000000000000000000
000000000000000000000111000000111100000000000000000000000000
000000000000000000000000000000111110000000000000000000000000
000000000000000000000000000000011110000000000000000000000000
000000000000000000000000000000001110000000000000000000000000
000000000000000000000000000000000000000000000000000000000000
000000000000000000000000000000000000000000000000000000000000