
000000000000000000000000000000000000000000000000000000000000
000000000000000000000000000000000000000000000000000000000000
000000000000000000000000000000000000000000000000000000000000
000000000000000000000000000000000000000000000000000000000000
000000000000000000000000000000000000000000000000000000000000
000000000000000000000000000000000000000000000000000000000000
000000000000000000000000000000011000000000000000000000000000
000000000000000000000000000001111110000000000000000000000000
000000000000000000000011000001111110000000000000000000000000
000000000000000000001111000000111100000000000000000000000000
000000000000000000111110000000000000000000000000000000000000
000000000000000000111110000000000000000001100000000000000000
000000000000000001111100000000000000000011110000000000000000
000000000000000000111110000000000000000111110000000000000000
000000000000000000011100000000000000001111111100000000000000
000000000000011000000000000000000000001000011100000000000000
000000000000000000000000001111110000000000011100000000000000
000000000000000000000000011111111100000000010000000000000000
000000000000000000000000011000001110000000010000000000000000
000000000000000000000000000000000000000000110000000000000000
000000000000000000000000000000000000000000000000000000000000
000000000001000000111000000000000000000000000000010000000000
000000000011110000011100000000000000000000000000111000000000
000000000011110000111110000011000000000000000000011000000000
000000000111111100011111000111000000000000000000011000000000
000000000011111101111111111111000000000000000000001000000000
000000000001111111111111111110000000000000001100000000000000
000000000001111111111111111100000000000000000111000000000000
000000000000111111001111111000000000000000000111000000000000
000000000000111100000111111000000000110000000011100000000000
000000000000111100000011111100010000111000000011110000000000
000000000000110000000001111111111000011000000111110000000000
000000000000000000000000111111111000011100000111111000000000
000000000000000000000000011111111100011111111111110000000000
000000000000000000000000001111111101111111111111000000000000
000000000000011100000000001111111111111100000100000000000000
000000000000011100000000001111111111111000000000000000000000
000000000000011110000000111111111111110000000000000000000000
000000000000001110000011111111111111100000000000000000000000
000000000000011111001111111111111111100000000000000000000000
000000000000001111111111111111111111000000000000000000000000
000000000000001111111111111111111000000000000000000000000000
000000000000000111111111111111110000000000000000000000000000
000000000000000001000001000011110000000000000000000000000000
000000000000000000000000000001110000000000000000000000000000
000000000000000000000000000001111000000000000000000000000000
000000000000000000000000000000111100000000000000000000000000
000000000000000000000000000000011111100000000000000000000000
000000000000000000000000000000000010000000000000000000000000
000000000000000000000000000000000000000000000000000000000000
000000000000000000000000000000000000000000000000000000000000