
000000000000000000000000000000000000000000000000000000000000
000000000000000000000000000000000000000000000000000000000000
000000000000000000000000000000000000000000000000000000000000
000000000000000000000000000000000000000000000000000000000000
000000000000000000000000000000000000000000000000000000000000
000000000000000000000000000000000000000000000000000000000000
000000000000000000000000000000010000000000000000000000000000
000000000000000000000000110000010000000000000000000000000000
000000000000000000000001110000000000000000000000000000000000
000000000000000000000001100000000000000010000000000000000000
000000000000000000000011100000000000001111100000000000000000
000000000000000000000011000000000000011111100000000000000000
000000000000000000000111000000000000111111100000000000000000
000000000000000011111110000000001111111110000000000000000000
000000000000000011111111000000011111110000000000000000000000
000000000000000111111111000000001111110000000000000000000000
000000000000000011111111000000001111000000000000000000000000
000000000000000011111111100000000110000000000000000000000000
000000000000000001000001100000000000000000000000000000000000
000000000000000000000000000000000000000001110000000000000000
000000000001000000000000000000000000000011110000000000000000
000000000011100000000000000000000000000111111000000000000000
000000000011110000000000001110000000000111111110000000000000
000000000111111000000000011111110000000011111111000000000000
000000000111111100000001111111111100000001111110000000000000
000000000011111110000011111110111111000000111110000000000000
000000000000011110000011111000000111000000011110000000000000
000000000000011110000011111000000000000000011110000000000000
000000000000011100000011111000000000000000011110000000000000
000000000011111100000011111100000000000000011110000000000000
000000000011111000000011111110000000000000111111000000000000
000000000011111000000111111111000000000000111111100000000000
000000000011111000000111111111110000000001111111000000000000
000000000011111000001111001111111110000000111110000000000000
000000000001111000001100000111111111000000111000000000000000
000000000001111000000000000011111111100000001000000000000000
000000000000111000000000000011111111000000000000000000000000
000000000000111000000000000001111111000000100000000000000000
000000000000011100000000000000111111000000100000000000000000
000000000000001110000000000000011111000000100000000000000000
000000000000001111000000000000001110000000000000000000000000
000000000000000111000000011100000000000000000000000000000000
000000000000000010000001111111000000000000000000000000000000
000000000000000000000000000011100000000000000000000000000000
000000000000000000000000000001111000000000000000000000000000
000000000000000000000000000000111110000000000000000000000000
000000000000000000000000000000111111000000000000000000000000
000000000000000000000000000000011111000000000000000000000000
000000000000000000000000000000000110000000000000000000000000
000000000000000000000000000000000000000000000000000000000000
000000000000000000000000000000000000000000000000000000000000