
000000000000000000000000000000000000000000000000000000000000
000000000000000000000000000000000000000000000000000000000000
000000000000000000000000000000000000000000000000000000000000
000000000000000000000000000000000000000000000000000000000000
000000000000000000000000000000000000000000000000000000000000
000000000000000000000000000000000000000000000000000000000000
000000000000000000000000000011111000000000000000000000000000
000000000000000000000000111111111110000000000000000000000000
000000000000000000000011111111111111110000000000000000000000
000000000000000000000111111111111111111100000000000000000000
000000000000000000001111111111111000000001000000000000000000
000000000000000000001111111011111000000111100000000000000000
000000000000000000001111100001111000000001000000000000000000
000000000000000000000110000000111100000000000000000000000000
000000000000000000000000000000011110000000000000000000000000
000000000000000100000000000000001111111000000000000000000000
000000000000011100000000000000000111111100000000000000000000
000000000000001110000000000000000011111110000000000000000000
000000000000011110000000011000000000111111000000000000000000
000000000000111110000001111000000000011111100000000000000000
000000000001111100000011110000000000001111100000000000000000
000000000011111000000111100000000000000111110000000000000000
000000000011111000001111000000000000000011111110000000000000
000000000011111100011111000000100000000001111111100000000000
000000000011111111111111100011110000000000011111110000000000
000000000001111111110111111111110000000000011111111000000000
000000000000111111000111111111111000000000000111111000000000
000000000000011111000011111111111111100000001111100000000000
000000000000001111101111111111111111100000000110000000000000
000000000000001111111111111001111111000000000100000000000000
000000000000000111111111111101111000000000000000000000000000
000000000000000111111111110011100000000000000000000000000000
000000000000000111111111000111100000000000000000110000000000
000000000000000111111110000011100000000100000000100000000000
000000000000001111001110000001110000011100000000000000000000
000000000000001110001110000001111111111000000000000000000000
000000000000001100000110000000111111110000000000000000000000
000000000000000000011110000000111111110000000000000000000000
000000000000000000011110000000011111110000000000000000000000
000000000000000001111110000000001111111000000000000000000000
000000000000000001111110000000000111111100000000000000000000
000000000000000001111110000000000011111000000000000000000000
000000000000000000011110000000000000100000000000000000000000
000000000000000000000111000000000000000000000000000000000000
000000000000000000000110000001100000000000000000000000000000
000000000000000000000000000011100000000000000000000000000000
000000000000000000000000000011110000000000000000000000000000
000000000000000000000000000111110000000000000000000000000000
000000000000000000000000000011110000000000000000000000000000
000000000000000000000000000000100000000000000000000000000000
000000000000000000000000000000000000000000000000000000000000