
000000000000000000000000000000000000000000000000000000000000
000000000000000000000000000000000000000000000000000000000000
000000000000000000000000000000000000000000000000000000000000
000000000000000000000000000000000000000000000000000000000000
000000000000000000000000000000000000000000000000000000000000
000000000000000000000000000000000000000000000000000000000000
000000000000000000000000000000000000000000000000000000000000
000000000000000000000000100000000000000000000000000000000000
000000000000000000000011100000000000000000000000000000000000
000000000000000000000111000000000000000000000000000000000000
000000000000000000000000000000000000000000000000000000000000
000000000000000000000000000000000000000001000000000000000000
000000000000000000000000000000100000000000000000000000000000
000000000000000000000000000000111000000000000000000000000000
000000000000000000000000000000111110101000000000000000000000
000000000000000000000010000000011111111100000000000000000000
000000000000001000000111100000000111111110000000000000000000
000000000000000000000111100000000111111110000000000000000000
000000000000000000001111110000000001111111000000000000000000
000000000000000000001111111000000000011111000000000000000000
000000000000000000001111111100000000000111110111000000000000
000000000000000000000111111110000000000111111111110000000000
000000000000110000000111111111000000000111111111111000000000
000000000001111100000011111111100000000011000001111000000000
000000000001011110000000111111111000000000000000111100000000
000000000000011110000000001111111110000000000000011100000000
000000000000001100000000000001111111000000000000000000000000
000000000000111100000000000000000011100000000000000000000000
000000000111111000000000000000000001100000000011000000000000
000000000111110000000000000000000000000000000111000000000000
000000000111100000001000000000000000000000001111100000000000
000000000011100000111100000000000000010000011111000000000000
000000000011100000111100000000000000010001111110000000000000
000000000001111011111100000000110000000111111110000000000000
000000000000000000111000000001111100000001111000000000000000
000000000000000000000000000011111110000001111000000000000000
000000000000000000000000000011111110000001110000000000000000
000000000000000000000000000011111111000011110000000000000000
000000000000000000000000010101111111111111111000000000000000
000000000000001100000011111110011111111111111110000000000000
000000000000001100000111111100001111111111111110000000000000
000000000000000000001111111110000011111000001110000000000000
000000000000000000011110001111000000100000000000000000000000
000000000000000000011100000111100000000000000000000000000000
000000000000000000011000000011110000000000000000000000000000
000000000000000000000000000001111000000000000000000000000000
000000000000000000000000000000111100000000000000000000000000
000000000000000000000000000000001000000000000000000000000000
000000000000000000000000000000000000000000000000000000000000
000000000000000000000000000000000000000000000000000000000000
000000000000000000000000000000000000000000000000000000000000