
000000000000000000000000000000000000000000000000000000000000
000000000000000000000000000000000000000000000000000000000000
000000000000000000000000000000000000000000000000000000000000
000000000000000000000000000000000000000000000000000000000000
000000000000000000000000000000000000000000000000000000000000
000000000000000000000000000000000000000000000000000000000000
000000000000000000000000001111000000000000000000000000000000
000000000000000000000000111111110000000000000000000000000000
000000000000000000000011111111110000000000000000000000000000
000000000000000000001111111111110000000000000000000000000000
000000000000000000011110000111100000000011000000000000000000
000000000000000000111100000000000000000111000000000000000000
000000000000000000111110000000000000001111100000000000000000
000000000000000000111110000000000000011111100000000000000000
000000000000000000111100000000000000111111100000000000000000
000000000000000000111000000000000001111110000000000000000000
000000000000000000110000000000000011111000000000000000000000
000000000000000011110000000000000111100000000000000000000000
000000000000000011110000000000000111100000000000000000000000
000000000000001111110000000000001111000001110000000000000000
000000000001111111111000000111000110000011110000000000000000
000000000011111111111000000111111110000011100000000000000000
000000000011111111111100000111111000000011100000000000000000
000000000111111111111110000111111000000000000000000000000000
000000000011111111001111001111100000000000000000000000000000
000000000011111111000111111111100000000000000001111000000000
000000000001111111000111111110000000000000000011111000000000
000000000001111111000011111110000000000000000011111000000000
000000000000111111100111111000000001000000000111110000000000
000000000000011111000111111000000111110000000111100000000000
000000000000000111000111110000011111111000001111000000000000
000000000000000000000111100000011111111000001111000000000000
000000000001000000000111000000111001111000011110000000000000
000000000001110000000110000000000000111000011110000000000000
000000000001111000000010000000000001110000001110000000000000
000000000000111100000010000000000001110000000100000000000000
000000000000011110000000000000000111100000000000000000000000
000000000000001110000000000000001111110000000000000000000000
000000000000000111100000011100001111100000000000000000000000
000000000000000011100000011100000111111000000000000000000000
000000000000000011111001111100000111111111111100000000000000
000000000000000011110111111000000111111111111100000000000000
000000000000000001001111111000000111111111111000000000000000
000000000000000000000111110000001111111110000000000000000000
000000000000000000000011100000011100001000000000000000000000
000000000000000000000000000000111000000000000000000000000000
000000000000000000000000000001111000000000000000000000000000
000000000000000000000000000001110000000000000000000000000000
000000000000000000000000000001110000000000000000000000000000
000000000000000000000000000000000000000000000000000000000000
000000000000000000000000000000000000000000000000000000000000