
000000000000000000000000000000000000000000000000000000000000
000000000000000000000000000000000000000000000000000000000000
000000000000000000000000000000000000000000000000000000000000
000000000000000000000000000000000000000000000000000000000000
000000000000000000000000000000000000000000000000000000000000
000000000000000000000000000000100000000000000000000000000000
000000000000000000000000001111100000000000000000000000000000
000000000000000000000000111100000000000000000000000000000000
000000000000000000000000110000000000000000000000000000000000
000000000000000000000000000000000000000000000000000000000000
000000000000000000000000000000000000000011100000000000000000
000000000000000000000000000000000000000111100000000000000000
000000000000000000000000000000000000011111110000000000000000
000000000000000000000000000000000101011111110000000000000000
000000000000000000111100000000011111111111010000000000000000
000000000000000001111111000000011111111100000000000000000000
000000000000000011111111000000001111111100000000000000000000
000000000000000011101111110000000001111100000000000000000000
000000000000000111000111110000000000111110000000000000000000
000000000000000110000111111000000000011111000000000000000000
000000000000001110000111111100000000001111100000000000000000
000000000000011100000111111110000000001111110001100000000000
000000000011111110000111111111000000000011111111100000000000
000000000111111100000111101111100000000001111111100000000000
000000000111111110000011101111110000000000111111000000000000
000000000111111110000011111111111100000000011110000000000000
000000000011111110000011111111111111000000001000000000000000
000000000000111111000011111000111111000000000000000000000000
000000000000011111000011110000111110000000000000000000000000
000000000000001111000001110000011100000000000000000000000000
000000000000000111000011111001111000000000000000000000000000
000000000000000000000001111111111000000000000011110000000000
000000000000000000000011111111111000000000001111111000000000
000000000000000000000000111111111100000000011111110000000000
000000000000000000000110000111111110000000011100000000000000
000000000000000000011100000001111111100000011000000000000000
000000000000011010111100000000011111100000011000000000000000
000000000000011111111000000000001111100000011000000000000000
000000000000001111111000000000001111000000111000000000000000
000000000000000111111000000000000111000000111100000000000000
000000000000000011111100000000001111000000111100000000000000
000000000000000011111111000000011111000000011100000000000000
000000000000000000001111111111111111000000000000000000000000
000000000000000000000111111111100011100000000000000000000000
000000000000000000000111111111100000000000000000000000000000
000000000000000000000111000111000000000000000000000000000000
000000000000000000000000000011110000000000000000000000000000
000000000000000000000000000011110000000000000000000000000000
000000000000000000000000000001110000000000000000000000000000
000000000000000000000000000000000000000000000000000000000000
000000000000000000000000000000000000000000000000000000000000