
000000000000000000000000000000000000000000000000000000000000
000000000000000000000000000000000000000000000000000000000000
000000000000000000000000000000000000000000000000000000000000
000000000000000000000000000000000000000000000000000000000000
000000000000000000000000000000000000000000000000000000000000
000000000000000000000000000000000000000000000000000000000000
000000000000000000000000000000011000000000000000000000000000
000000000000000000000000000000001000100000000000000000000000
000000000000000000000000000000000000111000000000000000000000
000000000000000000000011100000000000111100000000000000000000
000000000000000000111111100000000000011110000000000000000000
000000000000000001111111100000000000011110000000000000000000
000000000000000001111110000000000000011110000000000000000000
000000000000000001111111000000000000011100000000000000000000
000000000000000001111111000000000000011100000000000000000000
000000000000000001111111100000001000011100000000000000000000
000000000000000001111111100000000000011110000000000000000000
000000000000000000010110000000000000011110000000000000000000
000000000000000000000000000000000000011111000000000000000000
000000000000000000000000000000000000111111000000000000000000
000000000000000000000000000000000000011111000000000000000000
000000000001100000000000000000000000011111000000000000000000
000000000011100000001100000011000000000110000001110000000000
000000000011100000111111111111000000000000000000110000000000
000000000111110001111111111110000000000000000000111000000000
000000000011111111111111111100000000000000000000010000000000
000000000111111111111111110000000001000000000000000000000000
000000000111111111111111000000000111100000000000000000000000
000000000111111111111100000000011111100000000000000000000000
000000000111111111100000000000111111110000000110000000000000
000000000111000010000000000001111000000000011111100000000000
000000000111000000000000000011110000000000011111100000000000
000000000011000000000000000111100000000000011111100000000000
000000000011100000000000001111000000000000011111000000000000
000000000001110000000000011110000000000000011111000000000000
000000000001111100000111111110000000000000011110000000000000
000000000000111111111111111000000000000000111110000000000000
000000000000011111111111111000001111000001111110000000000000
000000000000001111111111111000111111100011111110000000000000
000000000000011111001111111111111111111111111110000000000000
000000000000001110000111111111111111111111111100000000000000
000000000000001110000111111111111111000000000000000000000000
000000000000000100001111000111111100000000000000000000000000
000000000000000000011110000011111100000000000000000000000000
000000000000000000011110000001111000000000000000000000000000
000000000000000000001000000000111000000000000000000000000000
000000000000000000000000000000011100000000000000000000000000
000000000000000000000000000000000100000000000000000000000000
000000000000000000000000000000000000000000000000000000000000
000000000000000000000000000000000000000000000000000000000000
000000000000000000000000000000000000000000000000000000000000