
000000000000000000000000000000000000000000000000000000000000
000000000000000000000000000000000000000000000000000000000000
000000000000000000000000000000000000000000000000000000000000
000000000000000000000000000000000000000000000000000000000000
000000000000000000000000000000000000000000000000000000000000
000000000000000000000000000000100000000000000000000000000000
000000000000000000000000001111110000000000000000000000000000
000000000000000000000000111111111000000000000000000000000000
000000000000000000000000111111110000000000000000000000000000
000000000000000000000000000111000000000000000000000000000000
000000000000000000000000000000000000000000000000000000000000
000000000000000001100000000000000000000000010000000000000000
000000000000000001110000000000000000000001111100000000000000
000000000000000001111000000000000000000011111100000000000000
000000000000000001111100000000001111111111111100000000000000
000000000000000001111110000000001111111111000000000000000000
000000000000000001111111000000011111111110000000000000000000
000000000000000001111111100000001111111100000000000000000000
000000000000000001110001110000001111111100000000000000000000
000000000000000001110000111000000011110000000000000000000000
000000000000000001110000011100000000000000000000000000000000
000000000000000001111000011110000000000000000000000000000000
000000000011000001111100011111000000000000011000000000000000
000000000111100001111111111111100000000000111111111000000000
000000000011110011111111111111110000000000111111111000000000
000000000011111111111111111111110000000000011111111100000000
000000000001111111110111111111111000000000011111110000000000
000000000011111111000111111001111000000000001111000000000000
000000000001111110000011111000111100000000001111000000000000
000000000011111100000111110000111000011000001111100000000000
000000000011111000001111111101111000001100001111110000000000
000000000001110000001111111111110000001110011111111000000000
000000000001110000011111111111100000001111111111110000000000
000000000000110000001111000010100000001111111110000000000000
000000000000111000001110000000000000011110101010000000000000
000000000000011100000000000000111111000000000000000000000000
000000000000011110000000000000011111110000000000000000000000
000000000000001111000000000000111111100000000000000000000000
000000000000001111111000000000111111110000000000000000000000
000000000000001111111110000000111111110000000000000000000000
000000000000000111111111000001111111111100000000000000000000
000000000000000000001111111111111111111100000000000000000000
000000000000000000000111111110000011111000000000000000000000
000000000000000000000111111000000001111000000000000000000000
000000000000000000000111000000000000110000000000000000000000
000000000000000000000100000000000000110000000000000000000000
000000000000000000000000000000000001100000000000000000000000
000000000000000000000000000000000000000000000000000000000000
000000000000000000000000000000000000000000000000000000000000
000000000000000000000000000000000000000000000000000000000000
000000000000000000000000000000000000000000000000000000000000