
000000000000000000000000000000000000000000000000000000000000
000000000000000000000000000000000000000000000000000000000000
000000000000000000000000000000000000000000000000000000000000
000000000000000000000000000000000000000000000000000000000000
000000000000000000000000000000000000000000000000000000000000
000000000000000000000000000000100000000000000000000000000000
000000000000000000000000001111110000000000000000000000000000
000000000000000000000000111111100000000000000000000000000000
000000000000000000000011111100000000000000000000000000000000
000000000000000000000011110000000000000010000000000000000000
000000000000000000000111100000000000000111000000000000000000
000000000000000000001111000000000000000111000000000000000000
000000000000000000011110000000000000011110000000000000000000
000000000000000000111110000000001000011110000000000000000000
000000000000000001111110000000011111111110000000000000000000
000000000000000011111111000000001111111110000000000000000000
000000000000000011111111000000001111111110000000000000000000
000000000000000111000111110000000111111110000000000000000000
000000000000000000000011110000000011111110000000000000000000
000000000000000000000001111100000000011111000000000000000000
000000000000000000000001111100000000001111000000000000000000
000000000011100000000001111110000000000110000000000000000000
000000000011110000000001111111000000000000000011110000000000
000000000011111000000001111111100000000000000011111000000000
000000000011111000000011111111110000000000000111111000000000
000000000001111100000011110011111000000000000111111000000000
000000000001111100000111100001111110000000000111100000000000
000000000000111110000111100001111111100000000110000000000000
000000000000011110000111110011111111100000000111000000000000
000000000000000100000011111111111111100000000110000000000000
000000000000000000000011111111111111000000001111000000000000
000000000000000000000001111111111111000000011111000000000000
000000000000000000000000111111111110000000111111000000000000
000000000000000000000000001111111110000000011110000000000000
000000000000010000000000001111111110000000000000000000000000
000000000000011101000000000011111111000000000000000000000000
000000000000001111110000000001111111000000000000000000000000
000000000000000111110000000000011111000000000000000000000000
000000000000000011110000000000001111100000000000000000000000
000000000000000001110000000000000011110000000000000000000000
000000000000000000000000000000000011111000001100000000000000
000000000000000000000000000000000001111000001100000000000000
000000000000000000000000000000000001111000000000000000000000
000000000000000000000000000000000001110000000000000000000000
000000000000000000011000000000000011100000000000000000000000
000000000000000000000000000011111111000000000000000000000000
000000000000000000000000000111111111000000000000000000000000
000000000000000000000000000111111110000000000000000000000000
000000000000000000000000000011111000000000000000000000000000
000000000000000000000000000000000000000000000000000000000000
000000000000000000000000000000000000000000000000000000000000