
000000000000000000000000000000000000000000000000000000000000
000000000000000000000000000000000000000000000000000000000000
000000000000000000000000000000000000000000000000000000000000
000000000000000000000000000000000000000000000000000000000000
000000000000000000000000000000000000000000000000000000000000
000000000000000000000000000000000000000000000000000000000000
000000000000000000000000000001110000000000000000000000000000
000000000000000000000000000111111000000000000000000000000000
000000000000000000000000000111111000000000000000000000000000
000000000000000000000000001111110000000000000000000000000000
000000000000000000000000000111111000000000000000000000000000
000000000000000000000000000001110000000111000000000000000000
000000000000000000000000000000111100000110000000000000000000
000000000000000000000110000000111100011110000000000000000000
000000000000000000011110000000111110000000000000000000000000
000000000000000101011111100001111100000000000000000000000000
000000000000011111111111111111110000000000000000000000000000
000000000000111111111111111111100000000000000000000000000000
000000000000111111011111011111000000000000000000000000000000
000000000000111111000111000110000000000000000000000000000000
000000000000011100000110000110000000000001100000000000000000
000000000000000000000110000110000000000011110000000000000000
000000000000000000001110000110000000000001111101100000000000
000000000000000000001110001111000000000001111111100000000000
000000000000000000111111101111000000000000111111100000000000
000000000000000000111111111111000000000000111111000000000000
000000000000111111111111111110000000000000111110000000000000
000000000000111111111111111110000000100000011111000000000000
000000000000111111111111111100000001111000000111000000000000
000000000000111111111111110000000000111000000011110000000000
000000000000111110001111000000000000000000000001111000000000
000000000001111100001110000000000000000000000000111000000000
000000000001111000001110000011000000000000000000000000000000
000000000011110000001110000111110000000000000000000000000000
000000000001110000001110000011111100000000000000000000000000
000000000001100000001100000011111110000000000000000000000000
000000000000000000000000000001111110000000000000000000000000
000000000000000000000000000001111110000000000000000000000000
000000000000000000000000000000011110000000111000000000000000
000000000000000000000000000000011111000011111100000000000000
000000000000001100000000000000000111111111111100000000000000
000000000000001110000000000000000111111110000000000000000000
000000000000000100000011100000000001111000000000000000000000
000000000000000000001111100000000000000000000000000000000000
000000000000000000000010000000110000000000000000000000000000
000000000000000000000000000000111100000000000000000000000000
000000000000000000000000000000001111000000000000000000000000
000000000000000000000000000000000011000000000000000000000000
000000000000000000000000000000000000000000000000000000000000
000000000000000000000000000000000000000000000000000000000000
000000000000000000000000000000000000000000000000000000000000