
000000000000000000000000000000000000000000000000000000000000
000000000000000000000000000000000000000000000000000000000000
000000000000000000000000000000000000000000000000000000000000
000000000000000000000000000000000000000000000000000000000000
000000000000000000000000000000000000000000000000000000000000
000000000000000000000000000000000000000000000000000000000000
000000000000000000000000001000000000000000000000000000000000
000000000000000000000000111000000000000000000000000000000000
000000000000000000000011100000000000001000000000000000000000
000000000000000000000011000000000000011110000000000000000000
000000000000000000001110000000000000011111000000000000000000
000000000000000000001110000000000000011111000000000000000000
000000000000000001111110000000000001111111100000000000000000
000000000000000011111111000000000001111101000000000000000000
000000000000000001111111100000000111110001000000000000000000
000000000000000000011111111111111111100000000000000000000000
000000000000000000001111111111111111000000000000000000000000
000000000000000000001111110000011110000000000000000000000000
000000000000000000001111100000000000000000000000000000000000
000000000000000000011111110000000000000000000000000000000000
000000000001000000111111110000000000000000000000100000000000
000000000011110001110101111100000000000000000001110000000000
000000000011111111100001111111000000000000000001111000000000
000000000011111111000000111111110000000000000000111000000000
000000000001111110000000111111110000000000000000011100000000
000000000000111100000001111111111000000000000000000000000000
000000000000000000000011000011111000000000000000000000000000
000000000000000000000110000001111000000000000000000000000000
000000000000000000000000000001111000000000000000000000000000
000000000000000000000000000011110000000000111100000000000000
000000000011000000000000000111110000000011111111000000000000
000000000011100000000000000111100000000011111111000000000000
000000000011110000000000001111111010111111111110000000000000
000000000001110000010000000111111111111101011000000000000000
000000000001111000000000000011111111100000000000000000000000
000000000000111100000000000001111111100000000000000000000000
000000000000011110000000000000111110000000000000000000000000
000000000000011111000000000000111110000000000000000000000000
000000000000001111110000000000111111000011111000000000000000
000000000000001111111100000000111111011111111110000000000000
000000000000000011111110000001111111111111111110000000000000
000000000000000000111110000001111111111000000000000000000000
000000000000000000011110000011110000100000000000000000000000
000000000000000000011100000011100000000000000000000000000000
000000000000000000001000000001110000000000000000000000000000
000000000000000000000000000001110000000000000000000000000000
000000000000000000000000000000111100000000000000000000000000
000000000000000000000000000000011111000000000000000000000000
000000000000000000000000000000000110000000000000000000000000
000000000000000000000000000000000000000000000000000000000000
000000000000000000000000000000000000000000000000000000000000