
000000000000000000000000000000000000000000000000000000000000
000000000000000000000000000000000000000000000000000000000000
000000000000000000000000000000000000000000000000000000000000
000000000000000000000000000000000000000000000000000000000000
000000000000000000000000000000000000000000000000000000000000
000000000000000000000000000000000000000000000000000000000000
000000000000000000000000000001000000000000000000000000000000
000000000000000000000000000111111110000000000000000000000000
000000000000000000000001011111111111111000000000000000000000
000000000000000000000111111111111111111110000000000000000000
000000000000000000001111111111111000011111000000000000000000
000000000000000000000111111111110000001111100000000000000000
000000000000000000001111100001000000001111100000000000000000
000000000000000000000111000000000000001111100000000000000000
000000000000000000001110000000000000011111101000000000000000
000000000000000000011110000000000001111111100000000000000000
000000000000000000111110000000000011111110000000000000000000
000000000000000001111110000000000011111000000000000000000000
000000000000000011111110000000000001100000000000000000000000
000000000000000111111110000000000000000000000000000000000000
000000000000111111111110000000000000000000000000000000000000
000000000011111111111110000000000000000000110000000000000000
000000000011110011111100000011000000000001111000110000000000
000000000111110011111110000011100000000001111111111000000000
000000000011110011111110000001110000000001111111111000000000
000000000011111111111111000001111000000001111111111000000000
000000000001111111111111110000011100000000100011110000000000
000000000001111111111111111000011100000000000001100000000000
000000000000111111101111111000011100000000000001100000000000
000000000000001110000011111110111000000000000001100000000000
000000000000000000000011111111111000001100000001110000000000
000000000000000000000001111111110000111110000000110000000000
000000000011000000000000011111100000111110000000000000000000
000000000001100000000000001111000001111110000000000000000000
000000000001110000000000000111000011111100000000000000000000
000000000000111110100000000010000011110000000000000000000000
000000000000011111111000000000000111100000000000000000000000
000000000000011111111000000000000111000000000000000000000000
000000000000001111111100000000001110000000000000000000000000
000000000000001111111110000000011110000000111000000000000000
000000000000001111111111010101111100000000111100000000000000
000000000000000110001111111111111100000000011100000000000000
000000000000000000000111111111111000000000000000000000000000
000000000000000000000111110011111100000000000000000000000000
000000000000000000000111100001111000000000000000000000000000
000000000000000000000011000000111100000000000000000000000000
000000000000000000000000000000011100000000000000000000000000
000000000000000000000000000000001100000000000000000000000000
000000000000000000000000000000000000000000000000000000000000
000000000000000000000000000000000000000000000000000000000000
000000000000000000000000000000000000000000000000000000000000