
000000000000000000000000000000000000000000000000000000000000
000000000000000000000000000000000000000000000000000000000000
000000000000000000000000000000000000000000000000000000000000
000000000000000000000000000000000000000000000000000000000000
000000000000000000000000000000000000000000000000000000000000
000000000000000000000000000000000000000000000000000000000000
000000000000000000000000001111111000000000000000000000000000
000000000000000000000000111111111000100000000000000000000000
000000000000000000000001111111000011110000000000000000000000
000000000000000000000000111100000000111000000000000000000000
000000000000000000000000000000000000111000000000000000000000
000000000000000011000000000000000000111000000000000000000000
000000000000000011000000000000000000111000000000000000000000
000000000000000111000000000000000000111000000000000000000000
000000000000000110000000000000000000111000000000000000000000
000000000000000000000111000000000011111000000000000000000000
000000000000000000001111110000111111111000000000000000000000
000000000000000000011111111100011111110000000001100000000000
000000000000000000011111111100000111110000000001100000000000
000000000000000000011000011100000001100000000011100000000000
000000000000000000000000011100000000000000000111110000000000
000000000001000000000000001100000000000000111111110000000000
000000000011110000000000011110000000000011111111111000000000
000000000111111000000000011111110000000011110101111000000000
000000000011111110000011111111111100000000000000111100000000
000000000011111110001111111111111111000000000000011100000000
000000000001111111111111111111111111000000000000001100000000
000000000001111111111111110001111110000000000000001100000000
000000000000011111111111100000000000000000000000011000000000
000000000000000111111111000000000000000000000000111100000000
000000000000000011111110000000000000000000001011111000000000
000000000011000001111100000000000000000000111111111000000000
000000000011100000111100000110000000000000111111110000000000
000000000001110000011000000111111100000000000000000000000000
000000000001111000000000000111111110000000000000000000000000
000000000000111000000000000011111111000000000000000000000000
000000000000011100000000000001111111000000000000000000000000
000000000000001100000000000001111111000000000000000000000000
000000000000001100000000000001111111100000001100000000000000
000000000000000000000010000001110111110000011110000000000000
000000000000000000000111000001110001110000011110000000000000
000000000000000000001111000001100000000000000100000000000000
000000000000000000001111000001100000000000000000000000000000
000000000000000000000100000001100000000000000000000000000000
000000000000000000000000000011100000000000000000000000000000
000000000000000000000000000111100000000000000000000000000000
000000000000000000000000000111000000000000000000000000000000
000000000000000000000000001111000000000000000000000000000000
000000000000000000000000000100000000000000000000000000000000
000000000000000000000000000000000000000000000000000000000000
000000000000000000000000000000000000000000000000000000000000