
000000000000000000000000000000000000000000000000000000000000
000000000000000000000000000000000000000000000000000000000000
000000000000000000000000000000000000000000000000000000000000
000000000000000000000000000000000000000000000000000000000000
000000000000000000000000000000000000000000000000000000000000
000000000000000000000000000000100000000000000000000000000000
000000000000000000000000000011110000000000000000000000000000
000000000000000000000000100111110000000000000000000000000000
000000000000000000000011110001110000000000000000000000000000
000000000000000000001111110000000000001110000000000000000000
000000000000000000000111000000000000001111000000000000000000
000000000000000000000000000000000000011111100000000000000000
000000000000000111100000000000000000011111000000000000000000
000000000000000111100000000000000000011111110000000000000000
000000000000001111110000000000000000011111111100000000000000
000000000000001111111000000000000000001011111100000000000000
000000000000000111111111100000000000001000111000000000000000
000000000000000000001111111000000000000000000000000000000000
000000000000000000000111111000000000110000000000000000000000
000000000000000000000111111100000000110000000000000000000000
000000000000000000000111111100000000110000000000000000000000
000000000000000000000111111100000000110000000000000000000000
000000000000000000000111111100000000000000000001110000000000
000000000000001000000111111100000000000000000111111000000000
000000000000011100000111111000000000000000011111111000000000
000000000000011000000111111000000111000000111111111000000000
000000000000011100000111111000000111000000011100000000000000
000000000000111100000111111000011111100000010100000000000000
000000000011111100000011111100111111100000000100000000000000
000000000111111000000011111111111111110000011111000000000000
000000000111111000000001111111111111110000011111000000000000
000000000111110000000000111111110011111001111111100000000000
000000000011110000000000011111100011111111111111000000000000
000000000011110000000000011111100011111111111100000000000000
000000000001111000000000001111111111111010100000000000000000
000000000001111111100000000111111111100000000000000000000000
000000000000111111111000000001111111000000000000000000000000
000000000000011111111100000000111110000000000000000000000000
000000000000001111101111000000011100000000000000000000000000
000000000000001110000000000000011000000110000000000000000000
000000000000001110000000000000110000011110000100000000000000
000000000000000110000000000111110000111100000000000000000000
000000000000000110000000000111110000111000000000000000000000
000000000000000000000000000001100000000000000000000000000000
000000000000000000000000000000000000000000000000000000000000
000000000000000000000000000000000000000000000000000000000000
000000000000000000000000000000000000000000000000000000000000
000000000000000000000000000000000000000000000000000000000000
000000000000000000000000000001100000000000000000000000000000
000000000000000000000000000000100000000000000000000000000000
000000000000000000000000000000000000000000000000000000000000