
000000000000000000000000000000000000000000000000000000000000
000000000000000000000000000000000000000000000000000000000000
000000000000000000000000000000000000000000000000000000000000
000000000000000000000000000000000000000000000000000000000000
000000000000000000000000000000000000000000000000000000000000
000000000000000000000000000000000000000000000000000000000000
000000000000000000000000001111110000000000000000000000000000
000000000000000000000000111111111000000000000000000000000000
000000000000000000000011111111111000000000000000000000000000
000000000000000000000011111111110000000000000000000000000000
000000000000000000001111000111111000000011000000000000000000
000000000000000000001110000011110000001111000000000000000000
000000000000000000111100000000111100001110000000000000000000
000000000000000000111000000000011111111110000000000000000000
000000000000000011110000000000001111111100000000000000000000
000000000000000011110000000000000111111100000000000000000000
000000000000001111100000000000001111111110000000000000000000
000000000000001111000000000000000111111110000000000000000000
000000000000011110000000000000000011111111100000000000000000
000000000000111110000000000000000000001111100000000000000000
000000000000111111000000000000000000000111100000110000000000
000000000001111111100000000000000000000011100000110000000000
000000000001110111111000000111100000000011100001110000000000
000000000001100001111111111111100000000001100001111000000000
000000000001000011111111111111110000000000000000111000000000
000000000000000001111111111101110000000000000001111000000000
000000000000000011111111111000011000000000000000100000000000
000000000000000011111111111000111100000000000010100000000000
000000000000000011110011111000011110000000000011000000000000
000000000000000011000001111000111111000000001111100000000000
000000000010000000000001111100011111110000011111110000000000
000000000111000000000001111100001111111111111111110000000000
000000000011100000000011111110000111111111110000000000000000
000000000011100000000111101110000111111111000000000000000000
000000000001110000001110001110000111111000000000000000000000
000000000000100000001100000000000111100000000000000000000000
000000000000000000011100000000000111000000000000000000000000
000000000000000000011100000000001110000000000000000000000000
000000000000000000011100000000011110000000000000000000000000
000000000000000100001110000000011111000000000000000000000000
000000000000001110000111111111111111111110000000000000000000
000000000000001110000111111111111111111110000000000000000000
000000000000000100000111111111111000000000000000000000000000
000000000000000000000111110000000000000000000000000000000000
000000000000000000000011000000000000000000000000000000000000
000000000000000000000000000000000000000000000000000000000000
000000000000000000000000000001110000000000000000000000000000
000000000000000000000000000011111000000000000000000000000000
000000000000000000000000000001110000000000000000000000000000
000000000000000000000000000000000000000000000000000000000000
000000000000000000000000000000000000000000000000000000000000