
000000000000000000000000000000000000000000000000000000000000
000000000000000000000000000000000000000000000000000000000000
000000000000000000000000000000000000000000000000000000000000
000000000000000000000000000000000000000000000000000000000000
000000000000000000000000000000000000000000000000000000000000
000000000000000000000000000000000000000000000000000000000000
000000000000000000000000001100000000000000000000000000000000
000000000000000000000000111100000000000000000000000000000000
000000000000000000000001111000000000000000000000000000000000
000000000000000000000001100000000000000010000000000000000000
000000000000000000000011100000000000001111000000000000000000
000000000000000000000010000000000000011110000000000000000000
000000000000000000000110000000000000111110000000000000000000
000000000000000000000110000000000000111000000000000000000000
000000000000000000000111000000000000000000000000000000000000
000000000000000100000111000000011000000000000000000000000000
000000000000011111011111100000011000000000000000000000000000
000000000000111111111111100000011100000000000000000000000000
000000000000111111111111110000001000000001000000000000000000
000000000001111111000001111000001000000011000000000000000000
000000000001111100000000111110000000000110000000100000000000
000000000011100000000000001110000000001110000001110000000000
000000000011000000000000000000000000001000000011111000000000
000000000011100000000000000000000000000000000001111000000000
000000000011111000000011000000000000000000000000011100000000
000000000001111100000111100000000110000000000000000000000000
000000000001111110000111100000000110000000000000000000000000
000000000001111110000011110000000111000000000000000000000000
000000000001111111000011111000000010000000000000000000000000
000000000000111111000001111100000000000000000000000000000000
000000000000000011100001111110000000000000000011100000000000
000000000000000001100000111111100000000000111111110000000000
000000000000000000110000111111110000000001111111100000000000
000000000000000000110000011111111110000000110000000000000000
000000000000000000111000001111111111000000000000000000000000
000000000000000000111000000011111111000000000000000000000000
000000000000000001111000000001111111100000000000000000000000
000000000000000011111000000000111111100000000000000000000000
000000000000000111110000000000111111111111111100000000000000
000000000000001111100000000000111111111111111110000000000000
000000000000001111100000000011111111111111111110000000000000
000000000000001111000000000111111111111110101000000000000000
000000000000000111000000001111111110100000000000000000000000
000000000000000011100000001111111000000000000000000000000000
000000000000000000111000000111111000000000000000000000000000
000000000000000000001000000011111000000000000000000000000000
000000000000000000000000000000111100000000000000000000000000
000000000000000000000000000000001100000000000000000000000000
000000000000000000000000000000000000000000000000000000000000
000000000000000000000000000000000000000000000000000000000000
000000000000000000000000000000000000000000000000000000000000