
000000000000000000000000000000000000000000000000000000000000
000000000000000000000000000000000000000000000000000000000000
000000000000000000000000000000000000000000000000000000000000
000000000000000000000000000000000000000000000000000000000000
000000000000000000000000000000000000000000000000000000000000
000000000000000000000000000000000000000000000000000000000000
000000000000000000000000000000001000000000000000000000000000
000000000000000000000000000000000100000000000000000000000000
000000000000000000000000000000000000000000000000000000000000
000000000000000000000000000000000000000010000000000000000000
000000000000000000000000000000000000000111100000000000000000
000000000000000000000000000000000000000111100000000000000000
000000000000000001000000000000000000001111000000000000000000
000000000000000011110000000000000000011100000000000000000000
000000000000000011111100000000000000011100000000000000000000
000000000000000011111111000000000011110000000000000000000000
000000000000000111001111000000001111111000000000000000000000
000000000000001110000111110000001111111000000000000000000000
000000000000011110000111110000000111111100000000000000000000
000000000000111100001111111000000001111111100000000000000000
000000000001111000001111111000000000011111110000000000000000
000000000011110000001010111100000000001111110000000000000000
000000000011110000000000111100000000000111111000000000000000
000000000111110000000000011000000000000011111010100000000000
000000000111111000000000011000000000000000011111111000000000
000000000011111100000000011000000000000000011111111100000000
000000000001111110000000011000000000000000001111111000000000
000000000001111111000000011000001100000000001111100000000000
000000000000111111100000011000011110000000001110000000000000
000000000001111111110000111100111110000000001110000000000000
000000000001111111111010111111111000000000011100000000000000
000000000011111111111111111111110000000000111100000000000000
000000000011111000111111111111110000000001111100000000000000
000000000001111000011111111111111000001000111100000000000000
000000000001110000001111000111111111111100011100000000000000
000000000000111000000110000011111111110000001000000000000000
000000000000011100000000000001111111000000000000000000000000
000000000000011100000000000000111100000000000000000000000000
000000000000000111000000000000111000000000000000000000000000
000000000000000000000000000001110000000000000000000000000000
000000000000000000000000000011110000000000011000000000000000
000000000000000000000111111111110000000000000000000000000000
000000000000000000001111111111110000000000000000000000000000
000000000000000000001111111111110000000000000000000000000000
000000000000000000001111110011111000000000000000000000000000
000000000000000000000111000001111110000000000000000000000000
000000000000000000000000000001111111000000000000000000000000
000000000000000000000000000001111110000000000000000000000000
000000000000000000000000000001111000000000000000000000000000
000000000000000000000000000000100000000000000000000000000000
000000000000000000000000000000000000000000000000000000000000