
000000000000000000000000000000000000000000000000000000000000
000000000000000000000000000000000000000000000000000000000000
000000000000000000000000000000000000000000000000000000000000
000000000000000000000000000000000000000000000000000000000000
000000000000000000000000000000000000000000000000000000000000
000000000000000000000000000000000000000000000000000000000000
000000000000000000000000000011110000000000000000000000000000
000000000000000000000000101111110000000000000000000000000000
000000000000000000000001111111000000000000000000000000000000
000000000000000000000001111000000000001110000000000000000000
000000000000000000000011100000000000001110000000000000000000
000000000000000000000111000000000000011110000000000000000000
000000000000000011110110000000000000111100000000000000000000
000000000000000111111100000000001111111100000000000000000000
000000000000001111111110000000011111111000000000000000000000
000000000000001111111110000000000111110000000000000000000000
000000000000001111001111100000000111111000000000000000000000
000000000000011110000111110000000011111010000000000000000000
000000000000001110000011111000000001111111000000000000000000
000000000000011111000001111000000000111111100000000000000000
000000000000111111100000111100000000011111100000000000000000
000000000001111111110000011110000000001111110000000000000000
000000000011100111111100001111000000000111111111100000000000
000000000011000011111110001111100000000001111111111000000000
000000000000000011111111111111100000000000011110111000000000
000000000000000011111111111111110000000000001110001100000000
000000000000000111111111111111110000000000001100000000000000
000000000000001111001111111101110000000000001100000000000000
000000000000011110000111111101100000000000011100000000000000
000000000000111110000111111111100000110000011100000000000000
000000000000111111001111111111100000110000111110000000000000
000000000001111111111111111111100001100000111110000000000000
000000000001111001111110000111110011100000111110000000000000
000000000001110000111100000001111111000000111110000000000000
000000000000110000011100000001111111000000001100000000000000
000000000000111000001000000000011110000000000000000000000000
000000000000011100000000000000111110000000000000000000000000
000000000000011100000000000000111100000000000000000000000000
000000000000011110000000011011111000000000000000000000000000
000000000000011110000000111111111000000001111110000000000000
000000000000001100000011111111111000000111111110000000000000
000000000000000000000011111111110000011101010100000000000000
000000000000000000001111000111111000111000000000000000000000
000000000000000000001110000011111001110000000000000000000000
000000000000000000001000000001111111100000000000000000000000
000000000000000000000000000000111111110000000000000000000000
000000000000000000000000000000011111100000000000000000000000
000000000000000000000000000000001111100000000000000000000000
000000000000000000000000000000000010000000000000000000000000
000000000000000000000000000000000000000000000000000000000000
000000000000000000000000000000000000000000000000000000000000