
000000000000000000000000000000000000000000000000000000000000
000000000000000000000000000000000000000000000000000000000000
000000000000000000000000000000000000000000000000000000000000
000000000000000000000000000000000000000000000000000000000000
000000000000000000000000000000000000000000000000000000000000
000000000000000000000000000000100000000000000000000000000000
000000000000000000000000001111111000000000000000000000000000
000000000000000000000000011110000000000000000000000000000000
000000000000000000000000011100000000000000000000000000000000
000000000000000000000000000000000000000110000000000000000000
000000000000000000000000000000000000001110000000000000000000
000000000000000000000000000000000000001110000000000000000000
000000000000000000111000000000000000011000000000000000000000
000000000000000000111100000000011000111000000000000000000000
000000000000000000001000000000011111110000000000000000000000
000000000000000000000000000000001111110000000000000000000000
000000000000001100000000000000001111111000000000000000000000
000000000000001100000000000000000111111100000000000000000000
000000000000011110000000010000000011111111000000000000000000
000000000000111111000001110000000001111111000000000000000000
000000000001111111100000000000000001111111100001100000000000
000000000001110111111111000000000000011111110011100000000000
000000000011100111111110000000000000000011111111100000000000
000000000011100011111110000000000000000001111111110000000000
000000000111110111111111100011110000000000111111111000000000
000000000111111111111111111111111000000000011111111100000000
000000000111111111101111111111111100000000011111111100000000
000000000111111111000111111010111111000000001111111110000000
000000000111111111000111111000111111110000000111111100000000
000000000111111110000111100000011111110000000011111100000000
000000000111110000000111100000111101111000000011111000000000
000000000011100000001111000000111111111000000011111000000000
000000000011100000001110000001111111111000000111110000000000
000000000001111000001110000001111111110000001111100000000000
000000000001111000001100000001111111110000011111000000000000
000000000000111110011100000001111111000000011110000000000000
000000000000111111111100000000111100000000001000000000000000
000000000000011111111100000000111000000000000000000000000000
000000000000001111111100000000111000000000000000000000000000
000000000000000111111110000001111000000000000000000000000000
000000000000000001111111111111111000000000000000000000000000
000000000000000000011111111111111000000000000000000000000000
000000000000000000001111111111110000000000000000000000000000
000000000000000000001110000011110000000000000000000000000000
000000000000000000001100000001100000000000000000000000000000
000000000000000000000000000001110000000000000000000000000000
000000000000000000000000000011110000000000000000000000000000
000000000000000000000000000011111110000000000000000000000000
000000000000000000000000000011111110000000000000000000000000
000000000000000000000000000000100000000000000000000000000000
000000000000000000000000000000000000000000000000000000000000