
000000000000000000000000000000000000000000000000000000000000
000000000000000000000000000000000000000000000000000000000000
000000000000000000000000000000000000000000000000000000000000
000000000000000000000000000000000000000000000000000000000000
000000000000000000000000000000000000000000000000000000000000
000000000000000000000000000000000000000000000000000000000000
000000000000000000000000001111000000000000000000000000000000
000000000000000000000000011111100000000000000000000000000000
000000000000000000000000111111110000000000000000000000000000
000000000000000000000000111000110000000000000000000000000000
000000000000000000000001110000011000000000000000000000000000
000000000000000000000011100000000000000000000000000000000000
000000000000000000000111000000011000000000000000000000000000
000000000000000000001111000000011000000011111000000000000000
000000000000000000011111000000011000001111111100000000000000
000000000000000111111111000000001010111111111100000000000000
000000000000001111111111000000000011111111111000000000000000
000000000000011111111111100000000011111111110000000000000000
000000000000111111000111100000000011111111100000000000000000
000000000001111100000111110000000001111110000000000000000000
000000000001111000000011100000000000000000000000000000000000
000000000011110000000111100000000000000000000000000000000000
000000000011100000000111000000000000000000000001100000000000
000000000111100000001111000000000000000000000111100000000000
000000000111110000011111000000010000000000000011000000000000
000000000111111111111111100000011000000000000000000000000000
000000000011011111111111100000011100000000000000000000000000
000000000000000111111111110000011111010000000000000000000000
000000000000000000101111111000011111111000000000000000000000
000000000000000000000011111100111111111000000000000000000000
000000000000000000000011111111111000000000000011100000000000
000000000000000000000000111111110000000000001111110000000000
000000000000000000000000111111110000000000011111100000000000
000000000000000000000000111111111000000000011111000000000000
000000000000000000000001111111111111000000001110000000000000
000000000000000000000011100001111111100000001110000000000000
000000000000001110001111100000111111000000000110000000000000
000000000000000110111110000000011111000000000110000000000000
000000000000001111111110000000001110000000000010000000000000
000000000000001111111100000000001100000000000000000000000000
000000000000000111111110000000000000000110000000000000000000
000000000000000011111111110000000000001110000000000000000000
000000000000000000011111111000000000001100000000000000000000
000000000000000000001111110000000000011100000000000000000000
000000000000000000001111110000000000111000000000000000000000
000000000000000000000111100000111101110000000000000000000000
000000000000000000000010000001111111100000000000000000000000
000000000000000000000000000001111111100000000000000000000000
000000000000000000000000000001111110000000000000000000000000
000000000000000000000000000000100000000000000000000000000000
000000000000000000000000000000000000000000000000000000000000