
000000000000000000000000000000000000000000000000000000000000
000000000000000000000000000000000000000000000000000000000000
000000000000000000000000000000000000000000000000000000000000
000000000000000000000000000000000000000000000000000000000000
000000000000000000000000000000000000000000000000000000000000
000000000000000000000000000000000000000000000000000000000000
000000000000000000000000000000110000000000000000000000000000
000000000000000000000000111111110000000000000000000000000000
000000000000000000000011111111100000000000000000000000000000
000000000000000000000001111111000000000000000000000000000000
000000000000000000000000011111000000000111100000000000000000
000000000000000000100000000000000000011111110000000000000000
000000000000000011111000000000010000111111100000000000000000
000000000000000111111000000000011111111100000000000000000000
000000000000001111111110000000111111111100000000000000000000
000000000000000000011110000000011111110000000000000000000000
000000000000000000001111100000001111111000000000000000000000
000000000000000000001111110000000001111000000000000000000000
000000000000000000001111111000000000111110000000000000000000
000000000000000000000111111100000000011111000000000000000000
000000000000000000001111111110000000001110000000100000000000
000000000000000000000011111110000000001110000011110000000000
000000000000100000001100111111000000000111000011111000000000
000000000001111000001000011110000000000011000001111000000000
000000000000111111111110111110000000000000000000111100000000
000000000000111111111111111100000000000000000000001000000000
000000000000111110011111110000000000000000000000000000000000
000000000000111100001111100000000000100000000000000000000000
000000000000111000001111000000000001110000000000000000000000
000000000001111000011110000000000001111000000000000000000000
000000000001110000011110000000000001111101011110000000000000
000000000011100000111110000000000011111111111111000000000000
000000000011100000111110000000000111111101111111000000000000
000000000011100000011111000000000111100001111111000000000000
000000000000000000111101010000000010000000011110000000000000
000000000000000000011100010000000000000000000000000000000000
000000000000000000111000000000000000000000000000000000000000
000000000000000000111000000000000000000000000000000000000000
000000000000000011111100000000000000000000000000000000000000
000000000000000111111100000000100000000000000000000000000000
000000000000001111111110000001111000000000000000000000000000
000000000000000100011110000011111000000000000000000000000000
000000000000000000001110000011110000000000000000000000000000
000000000000000000000110000011100000000000000000000000000000
000000000000000000000000000011100000000000000000000000000000
000000000000000000000000000011110000000000000000000000000000
000000000000000000000000000001111111100000000000000000000000
000000000000000000000000000001111111100000000000000000000000
000000000000000000000000000000011110000000000000000000000000
000000000000000000000000000000000000000000000000000000000000
000000000000000000000000000000000000000000000000000000000000