
000000000000000000000000000000000000000000000000000000000000
000000000000000000000000000000000000000000000000000000000000
000000000000000000000000000000000000000000000000000000000000
000000000000000000000000000000000000000000000000000000000000
000000000000000000000000000000000000000000000000000000000000
000000000000000000000000000000000000000000000000000000000000
000000000000000000000000001111000000000000000000000000000000
000000000000000000000000111111100000000000000000000000000000
000000000000000000000000111111100000000000000000000000000000
000000000000000000000000001111110000000000000000000000000000
000000000000000000000000000111100000000111000000000000000000
000000000000000000000000000011110000001110000000000000000000
000000000000000000001000000001110000001110000000000000000000
000000000000000000111100000000100000011100000000000000000000
000000000000000001111110000000000000000000000000000000000000
000000000000000011111110000000000000111000000000000000000000
000000000000001111111111000000000000111000000000000000000000
000000000000011111001111000000000001111110000000000000000000
000000000000011110001111100000000001111111000000000000000000
000000000000111100000111000000000000011111100000000000000000
000000000000111000001111000000000000000111110011100000000000
000000000001110000001110000000000000000111111111110000000000
000000000001110000011110000000000000000011111111110000000000
000000000000111000111110000000000000000011111111110000000000
000000000000111111111111000000000000000001111111000000000000
000000000000111111111111000000000000000000111110000000000000
000000000000111111101111100000000010000000011110000000000000
000000000001111110000011110000001111000000001111000000000000
000000000011111110000111111000111111000000000111100000000000
000000000011111100000111111111111111000000000111100000000000
000000000111111000001111111111111111100000001111100000000000
000000000111110000001111111110101111111111111111000000000000
000000000011110000011111111000000011111111111100000000000000
000000000011100000011111100000000011111111110000000000000000
000000000001110000011100000000000001000000000000000000000000
000000000000111000000000000000000000000000000000000000000000
000000000000011000000000000000000000000000000000000000000000
000000000000001000000000000000000000000000000000000000000000
000000000000001100000000000000011000000111111000000000000000
000000000000000100000000001111111111111111111110000000000000
000000000000000110000000111111111111111111111110000000000000
000000000000000110000011110111111111110000000000000000000000
000000000000000000000111110001111000000000000000000000000000
000000000000000000001111000011110000000000000000000000000000
000000000000000000011100000001110000000000000000000000000000
000000000000000000000000000111111000000000000000000000000000
000000000000000000000000000111111100000000000000000000000000
000000000000000000000000000011111100000000000000000000000000
000000000000000000000000000000010100000000000000000000000000
000000000000000000000000000000000000000000000000000000000000
000000000000000000000000000000000000000000000000000000000000