
000000000000000000000000000000000000000000000000000000000000
000000000000000000000000000000000000000000000000000000000000
000000000000000000000000000000000000000000000000000000000000
000000000000000000000000000000000000000000000000000000000000
000000000000000000000000000000000000000000000000000000000000
000000000000000000000000000000100000000000000000000000000000
000000000000000000000000001111111000000000000000000000000000
000000000000000000000000111100000000000000000000000000000000
000000000000000000000000110000000000000000000000000000000000
000000000000000000000000000000000000000000000000000000000000
000000000000000000000000000000000000000000000000000000000000
000000000000000000000000000000000000000011100000000000000000
000000000000000000000000000000000000001111100000000000000000
000000000000000001000000000000000000011111100000000000000000
000000000000000111000000000000001111111110000000000000000000
000000000000011111000000010000001111111100000000000000000000
000000000000011110000001111000000111111000000000000000000000
000000000000111000000001111100000111110000000000000000000000
000000000000111000000011111100000001000000000000000000000000
000000000001100000000011111100000000000000000000000000000000
000000000001100000000111111110000000000000000000000000000000
000000000011100000001111111110000000000000000000000000000000
000000000011110000011111111111000000000011111000000000000000
000000000001111000111111111111100000000001111100000000000000
000000000001111111111111111111110000000000011111000000000000
000000000000011111111111111111111000000000001111011000000000
000000000000011111110101111111111110000000001111110000000000
000000000000001111100000000000011111000000001111000000000000
000000000000111111000000000000001111100000001111000000000000
000000000000111110000000000000000111100000001111000000000000
000000000011111110000000000000000011110000001111000000000000
000000000011111100000000000010000001111000001111000000000000
000000000011111100000000000111000001111000001110000000000000
000000000001010000000000001111000001111100000110000000000000
000000000000000000000000001110000001111000000000000000000000
000000000000000000000000000100000011111000000000000000000000
000000000000000111000000000000000011110000000000000000000000
000000000000000111100000000000000111110000000000000000000000
000000000000000111110000000000000111110000000000000000000000
000000000000000111111100000000000111111000000000000000000000
000000000000000111111111000000000011111000000000000000000000
000000000000000111100011000000000011110000000000000000000000
000000000000000011100000000000000000000000000000000000000000
000000000000000001000000000000000000000000000000000000000000
000000000000000000000000000000100000000000000000000000000000
000000000000000000000000000001110000000000000000000000000000
000000000000000000000000000011111100000000000000000000000000
000000000000000000000000000001110000000000000000000000000000
000000000000000000000000000000000000000000000000000000000000
000000000000000000000000000000000000000000000000000000000000
000000000000000000000000000000000000000000000000000000000000