
000000000000000000000000000000000000000000000000000000000000
000000000000000000000000000000000000000000000000000000000000
000000000000000000000000000000000000000000000000000000000000
000000000000000000000000000000000000000000000000000000000000
000000000000000000000000000000000000000000000000000000000000
000000000000000000000000000000000000000000000000000000000000
000000000000000000000000000111000000000000000000000000000000
000000000000000000000000011111100000000000000000000000000000
000000000000000000000000011111000000000000000000000000000000
000000000000000000000000011111000000000010000000000000000000
000000000000000000000000000100000000000111000000000000000000
000000000000000000000000000000000000000111100000000000000000
000000000000000001110000000000000000001111100000000000000000
000000000000000000111000000000000001011111100000000000000000
000000000000000000111100000000000111111111000000000000000000
000000000000000000011111000000000111111110000000000000000000
000000000000011100001111100000000111111100000000000000000000
000000000000011100000111111000000011111000000000000000000000
000000000000011110000011111000000001111100000000000000000000
000000000001111100000011111100000000111100000000000000000000
000000000001111100000011111100000000011111000000000000000000
000000000011111000000111111100000000001111000000000000000000
000000000011111000001111111100000000000111111010000000000000
000000000011111000011111001100000000000001111111000000000000
000000000011111100111111111100000000000000001111100000000000
000000000000111111111111111100000000000000000111000000000000
000000000000111111111111111000000000000000000111000000000000
000000000000011111110111111000000111000000000111000000000000
000000000000011111000111110000001111100000000110000000000000
000000000000111100000011110000011111110000000111000000000000
000000000001111100000111100000011111111000001111000000000000
000000000011110000000011000001111111111100001111100000000000
000000000001111000000110000001111111111100001111110000000000
000000000001110000000110000001111111111000001111110000000000
000000000000111100011110000001111111100000001111100000000000
000000000000111101011110000001111111000000001110000000000000
000000000000011111111100000000111110000000001100000000000000
000000000000001111111100000000111110000000011100000000000000
000000000000001111111000000000011110000000111100000000000000
000000000000000111111000000000011111000001111100000000000000
000000000000000011100000000000001111110111111100000000000000
000000000000000000000000000000000111111111111000000000000000
000000000000000000000000000000000011111110000000000000000000
000000000000000000000000000011100001110000000000000000000000
000000000000000000000011000011110001110000000000000000000000
000000000000000000000111000001111111100000000000000000000000
000000000000000000000000000000111111100000000000000000000000
000000000000000000000000000000001111000000000000000000000000
000000000000000000000000000000000010000000000000000000000000
000000000000000000000000000000000000000000000000000000000000
000000000000000000000000000000000000000000000000000000000000