
000000000000000000000000000000000000000000000000000000000000
000000000000000000000000000000000000000000000000000000000000
000000000000000000000000000000000000000000000000000000000000
000000000000000000000000000000000000000000000000000000000000
000000000000000000000000000000000000000000000000000000000000
000000000000000000000000000000000000000000000000000000000000
000000000000000000000000000000111000000000000000000000000000
000000000000000000000000100000111000000000000000000000000000
000000000000000000000001100000000000000000000000000000000000
000000000000000000000011100000000000000110000000000000000000
000000000000000000000000000000000000001111000000000000000000
000000000000000001000000000000000000001111000000000000000000
000000000000000111100000000000000000001111000000000000000000
000000000000000111100000000000000000011110000000000000000000
000000000000001111100000000000000000001110000000000000000000
000000000000001111000000000000001000011100000000000000000000
000000000000011111000000000000011000011100000000000000000000
000000000000011111000000000000001110111110000000000000000000
000000000000011111100010000000001110011111100000000000000000
000000000000111111111110000000000100111111110000000000000000
000000000001111111111110000000000000001111100000000000000000
000000000011111111111100000111000000001111100000000000000000
000000000011110011111000000111000000000011000000000000000000
000000000111110011110000001111100000000000000000000000000000
000000000011110011100000001111110000000000000000000000000000
000000000011111111000000011111111000000000000000000000000000
000000000011111111000000011111111100000000000000000000000000
000000000001111111000001111111111111000000000000000000000000
000000000011111111010111111111111111100000000000000000000000
000000000001110000011111111000111111100000000000000000000000
000000000011100000001111110000011111110000000000000000000000
000000000000000000001111100000000111111000000000010000000000
000000000000000000001111000000000011111100000001111000000000
000000000000000000001110000000000111111100000011110000000000
000000000000000000001110000000000111110000000111100000000000
000000000000001000011100000000001111000000000110000000000000
000000000000011111111110000000001111000000001100000000000000
000000000000011111111100000000011110000000011100000000000000
000000000000001111111110000000011100000000111100000000000000
000000000000011111111110000000111100000001111100000000000000
000000000000001111001110000000111000000001111100000000000000
000000000000001110000111000001111000000000111000000000000000
000000000000000000000111000001110000000000000000000000000000
000000000000000000000111100001110000000000000000000000000000
000000000000000000000111000001100000000000000000000000000000
000000000000000000000010000001100000000000000000000000000000
000000000000000000000000000001110000000000000000000000000000
000000000000000000000000000000111000000000000000000000000000
000000000000000000000000000000111000000000000000000000000000
000000000000000000000000000000000000000000000000000000000000
000000000000000000000000000000000000000000000000000000000000