
000000000000000000000000000000000000000000000000000000000000
000000000000000000000000000000000000000000000000000000000000
000000000000000000000000000000000000000000000000000000000000
000000000000000000000000000000000000000000000000000000000000
000000000000000000000000000000000000000000000000000000000000
000000000000000000000000000000100000000000000000000000000000
000000000000000000000000001111111000000000000000000000000000
000000000000000000000000111111000111000000000000000000000000
000000000000000000000000111100000001111000000000000000000000
000000000000000000000000001100000000111110000000000000000000
000000000000000000000000000000000000011111100000000000000000
000000000000000000000000000000000000001111100000000000000000
000000000000000000000000000000000000001111110000000000000000
000000000000000000000000000000000000001111110000000000000000
000000000000000111000000000000000000000111111000000000000000
000000000000000111100000000000000000000011111000000000000000
000000000000000000000000100000000000000001111000000000000000
000000000000000000000011110000000000000000111000000000000000
000000000000000000000011110000000110000000110000000000000000
000000000000000000000111100000000110000001110000000000000000
000000000000000000000100000000000000000001100000000000000000
000000000001100000000000000000000000000011000000000000000000
000000000011110000000000000001000000000000000000000000000000
000000000011111000000000000111100000000000000001000000000000
000000000111111100000000000111000000000000000011110000000000
000000000011111110000000000110000000000000000111111000000000
000000000001111111000000000000000000000000000111111000000000
000000000000011111000000000000000000000000001111110000000000
000000000000011111000000000000000000000000001111110000000000
000000000000111110000000000000000000010000001111000000000000
000000000001111000000000000000000001110000001111000000000000
000000000011100000000000000111110101110000001110000000000000
000000000011000000000000011111111111110000011110000000000000
000000000000000000000000111111111111110000011110000000000000
000000000000000000000111111111111111100000011100000000000000
000000000000000000001111111111111111000000000000000000000000
000000000000000000000111110000000000000000000000000000000000
000000000000000000000111100000000000000000000000000000000000
000000000000000000000011000000000000000000000000000000000000
000000000000000000000011000000000000000000000000000000000000
000000000000000010000011000000000000000000000000000000000000
000000000000000110000011100000001110000000000000000000000000
000000000000000000000011100000111110000000000000000000000000
000000000000000000000111100000111110000000000000000000000000
000000000000000000000111100001111100000000000000000000000000
000000000000000000000010000001111110000000000000000000000000
000000000000000000000000000011111110000000000000000000000000
000000000000000000000000000001111111000000000000000000000000
000000000000000000000000000000000010000000000000000000000000
000000000000000000000000000000000000000000000000000000000000
000000000000000000000000000000000000000000000000000000000000