
000000000000000000000000000000000000000000000000000000000000
000000000000000000000000000000000000000000000000000000000000
000000000000000000000000000000000000000000000000000000000000
000000000000000000000000000000000000000000000000000000000000
000000000000000000000000000000000000000000000000000000000000
000000000000000000000000000000000000000000000000000000000000
000000000000000000000000000011111000000000000000000000000000
000000000000000000000000111111111100000000000000000000000000
000000000000000000000011111111111100000000000000000000000000
000000000000000000000111110000000000000110000000000000000000
000000000000000000000111100000000000001110000000000000000000
000000000000000000001111000000000000001111000000000000000000
000000000000000000000100000000000000011110000000000000000000
000000000000000000000000000000000000111110000000000000000000
000000000000000000000000000000000001111100000000000000000000
000000000000000000000000000000000001111000000000000000000000
000000000000001000000000010000000011110000000000000000000000
000000000000011110000001110000000011100000000000000000000000
000000000000111111000011110000000010000000000000000000000000
000000000001111111100111100000000000000011100000000000000000
000000000001111111111111000000000000000011100000000000000000
000000000011111011111111000000000000000111100000000000000000
000000000011100001111100000000000000000111100000000000000000
000000000111110001111110000000000000000011110000111000000000
000000000111110011111110001100000000000001110000011000000000
000000000011111111111111111111110000000000010000000000000000
000000000001111111011111111111111100000000000000000000000000
000000000000011100011111110101111111000000000000000000000000
000000000000000000001111100000111111100000000000000000000000
000000000000000000001111000000001111100000000000000000000000
000000000000000000001110000000000000000000001111100000000000
000000000000000000011110000000000000000000011111111000000000
000000000000000000011110000000000000000000111111111000000000
000000000000000000111111000000000000000000011111110000000000
000000000000000000111111110000001000000000111111000000000000
000000000000000000111111111000011100000000011100000000000000
000000000000000000111111111000001100000000111100000000000000
000000000000000001111000111000000100000001111000000000000000
000000000000000011110000111000000000000011110000000000000000
000000000000000111100000010000000100000111111000000000000000
000000000000000111000000110000011111111111110000000000000000
000000000000001111000001100000011111111111100000000000000000
000000000000000110000011100000111110111000000000000000000000
000000000000000000000111000000111000000000000000000000000000
000000000000000000001111000000111000000000000000000000000000
000000000000000000001100000000111000000000000000000000000000
000000000000000000000000000000111110000000000000000000000000
000000000000000000000000000000011110000000000000000000000000
000000000000000000000000000000001110000000000000000000000000
000000000000000000000000000000000000000000000000000000000000
000000000000000000000000000000000000000000000000000000000000