
000000000000000000000000000000000000000000000000000000000000
000000000000000000000000000000000000000000000000000000000000
000000000000000000000000000000000000000000000000000000000000
000000000000000000000000000000000000000000000000000000000000
000000000000000000000000000000000000000000000000000000000000
000000000000000000000000000000000000000000000000000000000000
000000000000000000000000001111111000000000000000000000000000
000000000000000000000000111111010000000000000000000000000000
000000000000000000000000111111000000000000000000000000000000
000000000000000000000000001100000000000000000000000000000000
000000000000000000000000000000000000000000000000000000000000
000000000000000000000000000000000000000001111000000000000000
000000000000000001110000000000010000000011111100000000000000
000000000000000011110000000000011111111111111100000000000000
000000000000000011110000000000011111111111111100000000000000
000000000000001111100000000000001111111100000000000000000000
000000000000001111100000000000001111110000000000000000000000
000000000000001111000000010000000111100000000000000000000000
000000000000001110000000011000000010000000000000000000000000
000000000000001110000000011000000000000001000000000000000000
000000000000001111000000001100000000000111100000000000000000
000000000000111111110000001100000000000111110000000000000000
000000000000111101111000000111000000000111111000000000000000
000000000011110001111100000111000000000001111110000000000000
000000000011111000111100000111110000000000011111100000000000
000000000011111001111110000111111000000000001111110000000000
000000000001111111111100001111111110000000000011100000000000
000000000000111111110000011100000111100000000111110000000000
000000000000011111100000000000000001111000000111100000000000
000000000000001111000000000000000001111100011111110000000000
000000000000000100000000000000000000111111011111110000000000
000000000000000000000000000000000001111111111111100000000000
000000000000000000000010000001110101111111111111100000000000
000000000000000000001111111111111111111111111110000000000000
000000000000000000001111111111111111111100000000000000000000
000000000000000000011111111111111111100000000000000000000000
000000000000000000011111111111111110000000000000000000000000
000000000000001000001100000000011000000000000000000000000000
000000000000001100000000000000000000000000000000000000000000
000000000000011100000000000000000000000000000000000000000000
000000000000001110000000000000000000001000000000000000000000
000000000000001110000000001110000000111000000000000000000000
000000000000000111000000111110000000111000000000000000000000
000000000000000011100011100000000000010000000000000000000000
000000000000000000111110000000000000000000000000000000000000
000000000000000000001000000000000000000000000000000000000000
000000000000000000000000000000000000000000000000000000000000
000000000000000000000000000000000000000000000000000000000000
000000000000000000000000000000000000000000000000000000000000
000000000000000000000000000000000000000000000000000000000000
000000000000000000000000000000000000000000000000000000000000