
000000000000000000000000000000000000000000000000000000000000
000000000000000000000000000000000000000000000000000000000000
000000000000000000000000000000000000000000000000000000000000
000000000000000000000000000000000000000000000000000000000000
000000000000000000000000000000000000000000000000000000000000
000000000000000000000000000000000000000000000000000000000000
000000000000000000000000001100000000000000000000000000000000
000000000000000000000000001101000000000000000000000000000000
000000000000000000000000000000000000000000000000000000000000
000000000000000000000000000000000000000010000000000000000000
000000000000000000000000000000000000001111100000000000000000
000000000000000000000000000000000000001111100000000000000000
000000000000000001111000000000000000111111100000000000000000
000000000000000001111000000000111000111111000000000000000000
000000000000000011111100000000111111111000000000000000000000
000000000000000011111000000000011111110000000000000000000000
000000000000000011100010000000011111100000000000000000000000
000000000000000111000011100000001111000000000000000000000000
000000000000000111000111100000000100000000000000000000000000
000000000000001111110111111000000000000011100000000000000000
000000000000011111111111111100000000000011100000000000000000
000000000000111111111111111110000000000111100000100000000000
000000000011111100111111111110000000000011100001110000000000
000000000111111000011111111111000000000011111001111000000000
000000000111111110111111111111000000000001111000111000000000
000000000111111111111111111111110000000000111110011100000000
000000000111111111111111111011110001000000011110001100000000
000000000111111111111111100000110111100000011110000000000000
000000000111011111111111100000000001110000011111101000000000
000000000111000111111110000000000001110000011111111000000000
000000000110000011111110000000000001111000011111111000000000
000000000011000001111100000000000001111000011110000000000000
000000000011100000111000000000000011110000011000000000000000
000000000001110000011000000111101011110000011100000000000000
000000000001111000011000000011111111100000001000000000000000
000000000000111100111000000011111111100000000000000000000000
000000000000111111111000000001111111000000000000000000000000
000000000000011111111000000001111111000000000000000000000000
000000000000001111111100000000111111000000000000000000000000
000000000000000111111111000000011111100000000000000000000000
000000000000000111001111100000001111100000000000000000000000
000000000000000000000011100000000111100000000000000000000000
000000000000000000000000000000000011000000000000000000000000
000000000000000000000000000000000011100000000000000000000000
000000000000000000000000000000000111000000000000000000000000
000000000000000000000000000000011111100000000000000000000000
000000000000000000000000000001111111000000000000000000000000
000000000000000000000000000011111110000000000000000000000000
000000000000000000000000000011000000000000000000000000000000
000000000000000000000000000000000000000000000000000000000000
000000000000000000000000000000000000000000000000000000000000