
000000000000000000000000000000000000000000000000000000000000
000000000000000000000000000000000000000000000000000000000000
000000000000000000000000000000000000000000000000000000000000
000000000000000000000000000000000000000000000000000000000000
000000000000000000000000000000000000000000000000000000000000
000000000000000000000000000000000000000000000000000000000000
000000000000000000000000000000000000000000000000000000000000
000000000000000000000000000000000000000000000000000000000000
000000000000000000000000000000000000000000000000000000000000
000000000000000000000011110000000000111000000000000000000000
000000000000000000001111100000000000011100000000000000000000
000000000000000000001111100000000000011111110000000000000000
000000000000000000111110000000000000011111111100000000000000
000000000000000000111111000000000000011110000100000000000000
000000000000000001111110000000000000011100000000000000000000
000000000000000001111111000000010000011100000000000000000000
000000000000000000111110000000000000011110000000000000000000
000000000000000000000000000000000000111110000000000000000000
000000000000000000000000000000000000111111000000000000000000
000000000000000000000000000000000000111111000000000000000000
000000000001000000000000000000000000111111000000000000000000
000000000011000000000000000000000000011110000000000000000000
000000000011100000001000000110000000000000000001110000000000
000000000111000000111111111110000000000000000001110000000000
000000000011110011111111111110000000000000000001111000000000
000000000111111111111111111000000000000000000000110000000000
000000000011111111111111100000000111000000000000000000000000
000000000011111111111110000000011111100000000000000000000000
000000000001111111100000000000111111100000000010000000000000
000000000000001110000000000001111100110000001111000000000000
000000000000000000000000000011111000000000011111000000000000
000000000000000000000000000111110000000000011111000000000000
000000000011000000000000001111100000000000111111000000000000
000000000011100000000000011111000000000000011110000000000000
000000000001110000000111111110000000000000111110000000000000
000000000001111111111111111000000000000000011100000000000000
000000000000111111111111100000000110000000111100000000000000
000000000000011111111110000000011111100001111100000000000000
000000000000001111111110000001111111101011111110000000000000
000000000000011111000000000011111111111111111100000000000000
000000000000001110000000001111111111111111000000000000000000
000000000000001110000010111111111110000000000000000000000000
000000000000000100001111111111111000000000000000000000000000
000000000000000000011111000011110000000000000000000000000000
000000000000000000011100000001110000000000000000000000000000
000000000000000000000000000000111000000000000000000000000000
000000000000000000000000000000011100000000000000000000000000
000000000000000000000000000000001100000000000000000000000000
000000000000000000000000000000000000000000000000000000000000
000000000000000000000000000000000000000000000000000000000000
000000000000000000000000000000000000000000000000000000000000