
000000000000000000000000000000000000000000000000000000000000
000000000000000000000000000000000000000000000000000000000000
000000000000000000000000000000000000000000000000000000000000
000000000000000000000000000000000000000000000000000000000000
000000000000000000000000000000000000000000000000000000000000
000000000000000000000000000000000000000000000000000000000000
000000000000000000000000000000011000000000000000000000000000
000000000000000000000000000000001111000000000000000000000000
000000000000000000000000111000000011111000000000000000000000
000000000000000000000000111100000000111110000000000000000000
000000000000000000000001111000000000011111100000000000000000
000000000000000000000001110000000000001111110000000000000000
000000000000000000000011100000000000001111110000000000000000
000000000000000000000111000000000000000111110000000000000000
000000000000000000011111000000000000000011110000000000000000
000000000000000000111111100000000000000000100000000000000000
000000000000000001111111110000000000000000000000000000000000
000000000000000001111111110000000100000000000000000000000000
000000000000000000101111110000000000000000000000000000000000
000000000000000000000011100000000000000000000000000000000000
000000000000000000000011110000000000000000000000000000000000
000000000001000000000001111000000000000000000000000000000000
000000000011110000000001111110000000000000000000000000000000
000000000011111000000000111110000000000000000100000000000000
000000000011111100000000111110000000000000011111110000000000
000000000000111110000000011100000000000000011111111000000000
000000000000111111000000011100000000000000011111111000000000
000000000000011111000000011000000000000000011111100000000000
000000000001111110000000011000000001100000011111000000000000
000000000011111000000001111000000111110000011110000000000000
000000000011100000000001111110111111110000011100000000000000
000000000000000000000111111111111111110000111100000000000000
000000000000000000000111111111111111111001111110000000000000
000000000000000000001111111111100011111111111111000000000000
000000000000000000001111111110000001111111111111000000000000
000000000000000000001111110000000001111000011111000000000000
000000000000000000001111100000000001110000000110000000000000
000000000000000110001111000000000011100000000000000000000000
000000000000000110111110000000000111000000000000000000000000
000000000000001111111110000000001111000000000000000000000000
000000000000001111111111000000011110000000000000000000000000
000000000000000111111111111111111110000000000000000000000000
000000000000000000001111111111111100000000000000000000000000
000000000000000000000111111111111100000000000000000000000000
000000000000000000000111000011111100000000000000000000000000
000000000000000000000000000001111111000000000000000000000000
000000000000000000000000000000111111110000000000000000000000
000000000000000000000000000000011111100000000000000000000000
000000000000000000000000000000000110000000000000000000000000
000000000000000000000000000000000000000000000000000000000000
000000000000000000000000000000000000000000000000000000000000