
000000000000000000000000000000000000000000000000000000000000
000000000000000000000000000000000000000000000000000000000000
000000000000000000000000000000000000000000000000000000000000
000000000000000000000000000000000000000000000000000000000000
000000000000000000000000000000000000000000000000000000000000
000000000000000000000000000000100000000000000000000000000000
000000000000000000000000001111111000000000000000000000000000
000000000000000000000000111111111000100000000000000000000000
000000000000000000000001110000000000111000000000000000000000
000000000000000000000011100000000000111100000000000000000000
000000000000000000000011000000000000011100000000000000000000
000000000000000000000110000000000000011100000000000000000000
000000000000000000000110000000000000011000000000000000000000
000000000000000000001111000000000000111000000000000000000000
000000000000000000011111000000000001110000000000000000000000
000000000000000000111111111111101011110000000000000000000000
000000000000001111110001111111111111100000000000000000000000
000000000000001111100000011111111110000000000000000000000000
000000000000001111000000011110000000000000000000000000000000
000000000000011110000000001100000000000001100000000000000000
000000000000111110000000001100000000000111110011000000000000
000000000011111100000000001110000000011111111111000000000000
000000000011111100000000001111000000111111111110000000000000
000000000111111100000000111111110011110101111110000000000000
000000000011111100000000111111111111110000111110000000000000
000000000011111110000011111111111111100000011110000000000000
000000000001111110000011110001111111100000001110000000000000
000000000000111111101111100001111000000000001110000000000000
000000000000011111111111000000110000000000001110000000000000
000000000000001111111110000011110000000000011110000000000000
000000000000000111111100000011110000000000111110000000000000
000000000000000011111100000111110000000000111100000000000000
000000000000000001111100000111110000000001111100000000000000
000000000000000000111100000111111000000000111000000000000000
000000000000000000011100000111111111000000010000000000000000
000000000000000000001100000011111111000000000000000000000000
000000000000000000000000000001111110000000000000000000000000
000000000000000000000000000001111100000000000000000000000000
000000000000000100000000000011111000000000000000000000000000
000000000000001110000000000111110000000001111100000000000000
000000000000001110000000001111100000000000011110000000000000
000000000000001110000000111111100000000000000100000000000000
000000000000000100000001111111100000000000000000000000000000
000000000000000000000011110111110000000000000000000000000000
000000000000000000001110000001111111000000000000000000000000
000000000000000000001000000001111111000000000000000000000000
000000000000000000000000000000111111000000000000000000000000
000000000000000000000000000000011111000000000000000000000000
000000000000000000000000000000001110000000000000000000000000
000000000000000000000000000000000000000000000000000000000000
000000000000000000000000000000000000000000000000000000000000