
000000000000000000000000000000000000000000000000000000000000
000000000000000000000000000000000000000000000000000000000000
000000000000000000000000000000000000000000000000000000000000
000000000000000000000000000000000000000000000000000000000000
000000000000000000000000000000000000000000000000000000000000
000000000000000000000000000000000000000000000000000000000000
000000000000000000000000000000010000000000000000000000000000
000000000000000000000000000001110000000000000000000000000000
000000000000000000000000000011110000000000000000000000000000
000000000000000000000110000111100000000000000000000000000000
000000000000000000001110000010000000000000000000000000000000
000000000000000000000110000000000000000000000000000000000000
000000000000000000000100000000000000000000000000000000000000
000000000000000000000000000000000101010000000000000000000000
000000000000000000000000000000001111111000000000000000000000
000000000000011100000000000000011111110000000000000000000000
000000000000011110000000000000001111100000000000000000000000
000000000000011111000000011000001111000000000000000000000000
000000000000011111000001111100000110000000100000000000000000
000000000000111111100111111100000000000001110000000000000000
000000000001111111111111111100000000000001110000000000000000
000000000001111111111111111000000000000011110000000000000000
000000000011111110000000000000000000000001110000100000000000
000000000011111100000000000000000000000001100001110000000000
000000000011111100000000000000000000000000000001110000000000
000000000001111100000000000000000000000000000001110000000000
000000000001111110000000000000000000000000000001100000000000
000000000001111111000000110000001111000000000001110000000000
000000000001111111100001110000001111100000000011100000000000
000000000011111111110111110000011111110000000111110000000000
000000000011100111111111100000011111111000011111110000000000
000000000011000011111111100000011111111111111111111000000000
000000000011000000111111000000011111111111111111110000000000
000000000001100000001111100000111111111111111111100000000000
000000000001110000001111111111111111111110000000000000000000
000000000000111100000111111111111111110000000000000000000000
000000000000011111101111111111111111100000000000000000000000
000000000000001111111111000001111111000000000000000000000000
000000000000000111111111000000011111000000000000000000000000
000000000000000111111110000000011111100000000000000000000000
000000000000000111111111000000001111111100000000000000000000
000000000000000111001110000000000011111100000000000000000000
000000000000000000000111000000000000010000000000000000000000
000000000000000000000110000000000000000000000000000000000000
000000000000000000000110000000000000000000000000000000000000
000000000000000000000100000000000000000000000000000000000000
000000000000000000000000000000000000000000000000000000000000
000000000000000000000000000000000011000000000000000000000000
000000000000000000000000000000000000000000000000000000000000
000000000000000000000000000000000000000000000000000000000000
000000000000000000000000000000000000000000000000000000000000