
000000000000000000000000000000000000000000000000000000000000
000000000000000000000000000000000000000000000000000000000000
000000000000000000000000000000000000000000000000000000000000
000000000000000000000000000000000000000000000000000000000000
000000000000000000000000000000000000000000000000000000000000
000000000000000000000000000000000000000000000000000000000000
000000000000000000000000000000000000000000000000000000000000
000000000000000000000000111000000000000000000000000000000000
000000000000000000000011111100000000000000000000000000000000
000000000000000000000011110000000000000010000000000000000000
000000000000000000000111100000000000000111000000000000000000
000000000000000000000110000000000000001111000000000000000000
000000000000000000000000000000000000001111000000000000000000
000000000000000000000000000000011100011110000000000000000000
000000000000000000000000000000011111111111000000000000000000
000000000000000000000000000000011111111110000000000000000000
000000000000000000000001000000001111111111000000000000000000
000000000000000000000011110000001111111111000000000000000000
000000000000001110000011111000000110101011000000000000000000
000000000000011000000001111100000000000000000001110000000000
000000000000000000000000111100000000000000000011100000000000
000000000000000000000000011100000000000000000111110000000000
000000000000000000000000011100000000000000001111110000000000
000000000000000000000000111000000000000000011111111000000000
000000000011111111111111111000000000000000111000011000000000
000000000001111111111111111000000000000000100000000000000000
000000000000011111111111111000000000000000000000000000000000
000000000000001111111111111000000100000000000000000000000000
000000000000000010000111111100000000000000000000000000000000
000000000000000000000011111110000000000000000100000000000000
000000000000000000000000111111000000000000011111100000000000
000000000000000000000000111111100000000001111111110000000000
000000000000000000000000011111110000111111111111110000000000
000000000000000000000000111111111111111111111000000000000000
000000000000000000000000010111111111111000000000000000000000
000000000000011100000000000001111111110000000000000000000000
000000000000011111111000000000111111100000000000000000000000
000000000000001111111100000000011111000000100000000000000000
000000000000001111111110000000011111000001111000000000000000
000000000000000111111110000000001111000000111110000000000000
000000000000000011111111000000001111000000011110000000000000
000000000000000000011111000000000010000000000100000000000000
000000000000000000001110000000000000000000000000000000000000
000000000000000000001110000000000000000000000000000000000000
000000000000000000001100000000000000000000000000000000000000
000000000000000000000000000111000000000000000000000000000000
000000000000000000000000000111000110000000000000000000000000
000000000000000000000000000110000010000000000000000000000000
000000000000000000000000000000000000000000000000000000000000
000000000000000000000000000000000000000000000000000000000000
000000000000000000000000000000000000000000000000000000000000