
000000000000000000000000000000000000000000000000000000000000
000000000000000000000000000000000000000000000000000000000000
000000000000000000000000000000000000000000000000000000000000
000000000000000000000000000000000000000000000000000000000000
000000000000000000000000000000000000000000000000000000000000
000000000000000000000000000000000000000000000000000000000000
000000000000000000000000000011110000000000000000000000000000
000000000000000000000000111111111111100000000000000000000000
000000000000000000000011111111111111111000000000000000000000
000000000000000000001111111111111000111110000000000000000000
000000000000000000001111000111110000111111000000000000000000
000000000000000000011110000011110000011111000000000000000000
000000000000000000011100000001111000011000000000000000000000
000000000000000000001000000000111100111000000000000000000000
000000000000000000000000000000011111110000000000000000000000
000000000000001000000000000000001111111100000000000000000000
000000000000011100000000000000000111111100000000000000000000
000000000000011100000000000000000001111110000000000000000000
000000000000111100000000111000000001111111000000000000000000
000000000001111000000000011000000000011111000000000000000000
000000000001111000000000110000000000011111000000000000000000
000000000011110000000001110000000000000111100010000000000000
000000000011111000000011110000000000000111111111000000000000
000000000011111111111111100000000000000001111110000000000000
000000000001111111111111110000100000000000011110000000000000
000000000000111111011111100000110000000000001110000000000000
000000000000011110000111110001111000000000001110000000000000
000000000000011110001111111000111111000000001110000000000000
000000000000001111101111111011111111000000011110000000000000
000000000000001111111111111111111110000000111100000000000000
000000000000000111111111111111110000000001111100000000000000
000000000000000011111111111111000000000001110000010000000000
000000000000000011111110000111100000000001000000000000000000
000000000000000000101000000011100000000000000000000000000000
000000000000001000000000000001111000000000000000000000000000
000000000000011000000000000001111110000000000000000000000000
000000000000011000000000000000111110000000000000000000000000
000000000000000000001000000000111111100000000000000000000000
000000000000000000111100000000011111111000000000000000000000
000000000000000001111100000000001111111100000000000000000000
000000000000000011111110000000001111111000000010000000000000
000000000000000001111110000000000011110000000000000000000000
000000000000000000111110000000000000000000000000000000000000
000000000000000000001110000000000000000000000000000000000000
000000000000000000000000000111000000000000000000000000000000
000000000000000000000000000111100000000000000000000000000000
000000000000000000000000001111100000000000000000000000000000
000000000000000000000000001111100000000000000000000000000000
000000000000000000000000000111100000000000000000000000000000
000000000000000000000000000000000000000000000000000000000000
000000000000000000000000000000000000000000000000000000000000