
000000000000000000000000000000000000000000000000000000000000
000000000000000000000000000000000000000000000000000000000000
000000000000000000000000000000000000000000000000000000000000
000000000000000000000000000000000000000000000000000000000000
000000000000000000000000000000000000000000000000000000000000
000000000000000000000000000000100000000000000000000000000000
000000000000000000000000001000100000000000000000000000000000
000000000000000000000000111100000000000000000000000000000000
000000000000000000000001110000000000000000000000000000000000
000000000000000000000000000000000000000110000000000000000000
000000000000000000000000000000000000001110000000000000000000
000000000000000001000000000000000000001111100000000000000000
000000000000000011100000000000010000011111111000000000000000
000000000000000111110000000000011100011111111100000000000000
000000000000000111100000000000011111110001111100000000000000
000000000000001111100000000000001111100000111000000000000000
000000000000001111000000010000000111110000110000000000000000
000000000000011111000001111000000011110001110000000000000000
000000000000111110000011111000000001111111100000000000000000
000000000000111111000111110000000000111111100000000000000000
000000000001111100011111000000000000011111100001100000000000
000000000001111100011110000000000000001111100001110000000000
000000000011111000111110000000000000000011000001110000000000
000000000011111101111111000011100000000000000001111000000000
000000000001111111111111011111110000000000000000111000000000
000000000000111111111111111111111000000000000000000000000000
000000000000011111111111111001111100000000000000000000000000
000000000000011111111111110000111110000000000000000000000000
000000000000001111011111110000111111000000000000000000000000
000000000000000100000111111001111111000000001111000000000000
000000000000000000000011111111111111100000011111110000000000
000000000010000000000000111111110001100000111111110000000000
000000000011000000000000011111111011110000011111100000000000
000000000001000000000000011111111111100000011110000000000000
000000000001100000000000001111111111100000001100000000000000
000000000000000000000000011111111111000000000000000000000000
000000000000000000111000000111111111000000000000000000000000
000000000000000000110000001001111111000000000000000000000000
000000000000000000000000000000111111000000000000000000000000
000000000000000000000000000000011111000000000000000000000000
000000000000000000000000000000011110000000011100000000000000
000000000000001110000000000000001100000000001100000000000000
000000000000000100000000000000101000000000000000000000000000
000000000000000000000000000000100000000000000000000000000000
000000000000000000000000000011110000000000000000000000000000
000000000000000000000000000111110000000000000000000000000000
000000000000000000000000000111110000000000000000000000000000
000000000000000000000000000011110000000000000000000000000000
000000000000000000000000000000000000000000000000000000000000
000000000000000000000000000000000000000000000000000000000000
000000000000000000000000000000000000000000000000000000000000