
000000000000000000000000000000000000000000000000000000000000
000000000000000000000000000000000000000000000000000000000000
000000000000000000000000000000000000000000000000000000000000
000000000000000000000000000000000000000000000000000000000000
000000000000000000000000000000000000000000000000000000000000
000000000000000000000000000000100000000000000000000000000000
000000000000000000000000000011100000000000000000000000000000
000000000000000000000000001111100000000000000000000000000000
000000000000000000000000011111000000000000000000000000000000
000000000000000000000000011111000000000110000000000000000000
000000000000000000000000001111100000001111000000000000000000
000000000000000000000000000011110000011111000000000000000000
000000000000000000000000000001111000011110000000000000000000
000000000000000000100000000000111111111100000000000000000000
000000000000000001100000000000011111111100000000000000000000
000000000000000001000000000000011111111000000000000000000000
000000000000000000000011100000001111111100000000000000000000
000000000000000000000011110000001111111100000000000000000000
000000000000000000000111111000000111111110000000000000000000
000000000000000000000111111000000000011110000000000000000000
000000000000000000000111111000000000000111000001000000000000
000000000000000000001111111100000000000111100111110000000000
000000000001000000011111111110000000000011111111110000000000
000000000011111111111111111111000000000001111111111000000000
000000000011111111111111111111100000000000011111111000000000
000000000001111111111111111111111000000000001111011100000000
000000000000111111111111111000011110000000001110001100000000
000000000000111111001111110000011111000000001110001110000000
000000000000011110000111110000001111100000000111011100000000
000000000001111110000011111000111111100000000111111100000000
000000000001111111000001111111111111110000000011111000000000
000000000001111111100000111111111011111000000011111000000000
000000000001110000100000111111111001111000000011110000000000
000000000000110000000000011111111011111000000011000000000000
000000000000110000000000001111111111111000000000000000000000
000000000000110000000000000111111111110000000000000000000000
000000000000010000000000000001111111100000000000000000000000
000000000000011000000000000000111111100000000000000000000000
000000000000011000000000000000111111100000000000000000000000
000000000000011100000001000001111111110000000000000000000000
000000000000001100000011111111111111110000000110000000000000
000000000000001100000111111111110000100000000000000000000000
000000000000000000000111100111100000000000000000000000000000
000000000000000000000111000011100000000000000000000000000000
000000000000000000000110000001110000000000000000000000000000
000000000000000000000100000000111000000000000000000000000000
000000000000000000000000000000011111000000000000000000000000
000000000000000000000000000000000111100000000000000000000000
000000000000000000000000000000000000000000000000000000000000
000000000000000000000000000000000000000000000000000000000000
000000000000000000000000000000000000000000000000000000000000