
000000000000000000000000000000000000000000000000000000000000
000000000000000000000000000000000000000000000000000000000000
000000000000000000000000000000000000000000000000000000000000
000000000000000000000000000000000000000000000000000000000000
000000000000000000000000000000000000000000000000000000000000
000000000000000000000000000000100000000000000000000000000000
000000000000000000000000000011100000000000000000000000000000
000000000000000000000000001111000000000000000000000000000000
000000000000000000000000011100000000000000000000000000000000
000000000000000000000000000000000000000000000000000000000000
000000000000000000000000000000000000001111000000000000000000
000000000000000000110000000000000000111111110000000000000000
000000000000000001111000000000000001111111111000000000000000
000000000000000011111000000000011111111111111000000000000000
000000000000000111100000000001111111111110000000000000000000
000000000000001111000000000011111111111100000000000000000000
000000000000011110000000001111111111111100000000000000000000
000000000000111100000000011111111111111000000000000000000000
000000000000111100000000001100001111101000000000000000000000
000000000001111000000000000000000000000000000000000000000000
000000000000110000000000000000000000000110000000000000000000
000000000001110000010000000000000000000011000001000000000000
000000000001111001111100000000000000000010000011110000000000
000000000011111111111110000001100000000000000011110000000000
000000000011111111111111000001100000000000000011110000000000
000000000111111111111111100000000000000000000011100000000000
000000000011111111111111110000000000000000000111000000000000
000000000111111111001111110000000000000000000111000000000000
000000000011111110000111111000000000000000001111000000000000
000000000111111110000011111000000001110000001111000000000000
000000000111111111000001111110000001110000011111100000000000
000000000111111111100000111111111111110000011111000000000000
000000000011110001110000011111111111100000111110000000000000
000000000011110000000000011111111111100000011100000000000000
000000000001110000000000011100111111000000000000000000000000
000000000000110000000000011000011110000000000000000000000000
000000000000011000000000011000011100000000000000000000000000
000000000000011000000000111100111000000000000000000000000000
000000000000011100000000111111111000000000000000000000000000
000000000000011100000001111111111000000000000000000000000000
000000000000001100000001111111111000000000000000000000000000
000000000000000000000011111111110000000000000000000000000000
000000000000000000000001000111111000000000000000000000000000
000000000000000000000000000011110000000000000000000000000000
000000000000000000000000000011111000000000000000000000000000
000000000000000000000000000001110000000000000000000000000000
000000000000000000000000000001111000000000000000000000000000
000000000000000000000000000000110000000000000000000000000000
000000000000000000000000000000000000000000000000000000000000
000000000000000000000000000000000000000000000000000000000000
000000000000000000000000000000000000000000000000000000000000