
000000000000000000000000000000000000000000000000000000000000
000000000000000000000000000000000000000000000000000000000000
000000000000000000000000000000000000000000000000000000000000
000000000000000000000000000000000000000000000000000000000000
000000000000000000000000000000000000000000000000000000000000
000000000000000000000000000000000000000000000000000000000000
000000000000000000000000001111111000000000000000000000000000
000000000000000000000000111111111100000000000000000000000000
000000000000000000000001111111100000000000000000000000000000
000000000000000000000000111110000000000000000000000000000000
000000000000000000000000001000000000000111000000000000000000
000000000000000000000000000000000000000111100000000000000000
000000000000000001110000000000000000001111000000000000000000
000000000000000000111100000000000000011110000000000000000000
000000000000000000111100000000010000011100000000000000000000
000000000000000000111110000000000000111000000000000000000000
000000000000000000111111000000000000110000000000000000000000
000000000000000000011111100000000001111000000000000000000000
000000000000000000011111111000000001111000000000000000000000
000000000000000000000111111100000000111000000000000000000000
000000000000100000001111111110000000001110000000000000000000
000000000011110000001111111100000000001110000000110000000000
000000000011111000001100111110000000000011000000111000000000
000000000011111000111100011100000000000000000000111000000000
000000000001111110111000011110000000000000000000011100000000
000000000001111111111000011110000000000000000000011100000000
000000000001111111110000011100000000000000000000000000000000
000000000001111111110000000000001111110000000000000000000000
000000000001111111110000000000011111110000000000000000000000
000000000001111111110000000000011111110000000000000000000000
000000000011111111111000000000011111110000000000000000000000
000000000011110001111100000000001111110000001110000000000000
000000000011100000011110000000000011110000011110000000000000
000000000000000000011110000000000001110000011100000000000000
000000000000000000000111100000000001100000001000000000000000
000000000000000000001111110000000000000000000000000000000000
000000000000000000001111110000000000000000000000000000000000
000000000000000001111110000000000000000000000000000000000000
000000000000000111111100000000000000000000000000000000000000
000000000000001111111100000000000000000000000000000000000000
000000000000001111111110000011111000000000000000000000000000
000000000000000111111111111111110000000000000000000000000000
000000000000000000011111111111100000001000000000000000000000
000000000000000000001111100000000000011000000000000000000000
000000000000000000001111000000000000111000000000000000000000
000000000000000000000100000000000001111000000000000000000000
000000000000000000000000000000111111110000000000000000000000
000000000000000000000000000001111111100000000000000000000000
000000000000000000000000000000111110000000000000000000000000
000000000000000000000000000000000000000000000000000000000000
000000000000000000000000000000000000000000000000000000000000