
000000000000000000000000000000000000000000000000000000000000
000000000000000000000000000000000000000000000000000000000000
000000000000000000000000000000000000000000000000000000000000
000000000000000000000000000000000000000000000000000000000000
000000000000000000000000000000000000000000000000000000000000
000000000000000000000000000000000000000000000000000000000000
000000000000000000000000001111111000000000000000000000000000
000000000000000000000000111111111000000000000000000000000000
000000000000000000000000111111110000000000000000000000000000
000000000000000000000001111111110000000000000000000000000000
000000000000000000000001111111100000000000000000000000000000
000000000000000000000011100001110000000000000000000000000000
000000000000000011100011000000010000000000000000000000000000
000000000000000011111010000000011100000000000000000000000000
000000000000000011111010000000011111100000000000000000000000
000000000000000011100000000000011111111000000000000000000000
000000000000000011110000000000001111111110000000000000000000
000000000000000011100000000000000001111110000000000000000000
000000000000000111111000000000000000111111000000000000000000
000000000000000111110000000000000000011111000000000000000000
000000000000111111111000001100000000001111100000000000000000
000000000000111111110000001110000000000111110000000000000000
000000000000011111111000001110000000000001111010100000000000
000000000000001111111000001111000000000001111111111000000000
000000000000001111111110011111100000000000011111111000000000
000000000000001111111111111111111000000000011111001100000000
000000000000001110111111111110011110000000001110000100000000
000000000000011100001111111100001111000000001110000000000000
000000000000011000001111111100000111000000001110000000000000
000000000001110000000111111110000111100000001110000000000000
000000000011110000001111111110000111100000011111000000000000
000000000001110000001111111111110111100000111111110000000000
000000000001110000001110001111110111110001111111100000000000
000000000001110000001000001111110001111111111111000000000000
000000000001111000000000000111100011111101111110000000000000
000000000000111000000000000011100001111001111100000000000000
000000000000111100000000000001110011110000011000000000000000
000000000000011100000000000000111011100000111000000000000000
000000000000011110000000000000111110000000011000000000000000
000000000000011100000111000000111010000000000000000000000000
000000000000001110000011000000111000000000000000000000000000
000000000000001100000011100000110001100000000000000000000000
000000000000000100000011100000110001100000000000000000000000
000000000000000000000111100000110001100000000000000000000000
000000000000000000001111100001110001100000000000000000000000
000000000000000000001110000011110001100000000000000000000000
000000000000000000000000000011111111100000000000000000000000
000000000000000000000000000111111111000000000000000000000000
000000000000000000000000000011111110000000000000000000000000
000000000000000000000000000000100000000000000000000000000000
000000000000000000000000000000000000000000000000000000000000