
000000000000000000000000000000000000000000000000000000000000
000000000000000000000000000000000000000000000000000000000000
000000000000000000000000000000000000000000000000000000000000
000000000000000000000000000000000000000000000000000000000000
000000000000000000000000000000000000000000000000000000000000
000000000000000000000000000000000000000000000000000000000000
000000000000000000000000000001111000000000000000000000000000
000000000000000000000000010111111000000000000000000000000000
000000000000000000000001111111111000000000000000000000000000
000000000000000000000011111111110000000000000000000000000000
000000000000000000000011110000000000000001000000000000000000
000000000000000000000000000000000000000011100000000000000000
000000000000000000001000000000000000000111110000000000000000
000000000000000000111000000000000000000111111000000000000000
000000000000000001111000000000011000011111111100000000000000
000000000000000011110000000000011000011111100000000000000000
000000000000000011110000000000010000111111100000000000000000
000000000000000011100000000000000001111111000000000000000000
000000000000000011100000110000000000111111100000000000000000
000000000000000001100000111000000000111111100000000000000000
000000000000000001100000011000000000001111100000000000000000
000000000011100001110000011100000000001111100000000000000000
000000000011110001110000011110000000000111000000000000000000
000000000111111111111100011111100000000111000000100000000000
000000000111111111111101111111111000000000000011111000000000
000000000011111111111111111111111110000000000011111100000000
000000000001111000011111111110001111000000000111111100000000
000000000000000000011111111100000011000000000111101000000000
000000000000000000000111111100000000000000001111000000000000
000000000000000000001111111100000000000000011110000000000000
000000000000000000000011111110000000000000011100000000000000
000000000000000000000000111111000000000000111000000000000000
000000000000000000000000011111100000000000110000000000000000
000000000000000000000000011111111000000000000000000000000000
000000000000000000000000011111111111000000000000000000000000
000000000000000110000000001000111111100000000000000000000000
000000000000001111000000000000011111100000000000000000000000
000000000000001111111100000000011111100000000000000000000000
000000000000001111111111000000011111100000001100000000000000
000000000000001111111111000000001111100000000100000000000000
000000000000001111111111100000001111100000000000000000000000
000000000000000111101111100000000111110000000000000000000000
000000000000000111000011100000000001110000000000000000000000
000000000000000000000000000000000000000000000000000000000000
000000000000000000000000000000000000000000000000000000000000
000000000000000000000000000000000000000000000000000000000000
000000000000000000000000000011100000000000000000000000000000
000000000000000000000000000111111000000000000000000000000000
000000000000000000000000000011111000000000000000000000000000
000000000000000000000000000000100000000000000000000000000000
000000000000000000000000000000000000000000000000000000000000