
000000000000000000000000000000000000000000000000000000000000
000000000000000000000000000000000000000000000000000000000000
000000000000000000000000000000000000000000000000000000000000
000000000000000000000000000000000000000000000000000000000000
000000000000000000000000000000000000000000000000000000000000
000000000000000000000000000000000000000000000000000000000000
000000000000000000000000000000001000000000000000000000000000
000000000000000000000000000000111100000000000000000000000000
000000000000000000000001000001111100000000000000000000000000
000000000000000000000011111111111000000000000000000000000000
000000000000000000000011111111000000000000000000000000000000
000000000000000000000011111100000000000000100000000000000000
000000000000000000000111000000000000000000100000000000000000
000000000000000000001110000000000000000000000000000000000000
000000000000000000011110000000000100000000000000000000000000
000000000000000000111100000000001111010000000000000000000000
000000000000000001111100000000001111111100000000000000000000
000000000000000001111000000000001111111111000000000000000000
000000000000000011110000000000000101011111100000000000000000
000000000000000001110000000000000000011111100000000000000000
000000000000000001110000011100000000000111110000000000000000
000000000011100000110000001100000000000111110000000000000000
000000000011110000011000001110000000000011110000000000000000
000000000111111000011000001110000000000001110000000000000000
000000000011111100111100001111000000000001100000010000000000
000000000011111111111110011110000000000000000001111100000000
000000000001111111111111111110000011000000000001111100000000
000000000000111111101111111100000011100000000011111100000000
000000000000001100001111111110000001100000000011110000000000
000000000000000000000111111100000000000000000111110000000000
000000000000000000000111111110000000000000001111000000000000
000000000000000000000111111111000000000000001111000000000000
000000000000000000000110111111000000000000011110000000000000
000000000000000000001110001111110000000000011100000000000000
000000000000000000001100001111110000000000000000000000000000
000000000000000000111000001111011111000000000000000000000000
000000000000000011111100000100001111100000000000000000000000
000000000000000111111100000000001111110000000000000000000000
000000000000000011111110000000000111110000000000000000000000
000000000000000111111111000000000111110000000000000000000000
000000000000000011111111100000000011110000000000000000000000
000000000000000111111111110000000011110000000000000000000000
000000000000000011111111110000000001110000000000000000000000
000000000000000011101011110000000000111000000000000000000000
000000000000000000000000000000000000000000000000000000000000
000000000000000000000000000000000000000000000000000000000000
000000000000000000000000000000100000000000000000000000000000
000000000000000000000000000001110000000000000000000000000000
000000000000000000000000000001110000000000000000000000000000
000000000000000000000000000000100000000000000000000000000000
000000000000000000000000000000000000000000000000000000000000