
000000000000000000000000000000000000000000000000000000000000
000000000000000000000000000000000000000000000000000000000000
000000000000000000000000000000000000000000000000000000000000
000000000000000000000000000000000000000000000000000000000000
000000000000000000000000000000000000000000000000000000000000
000000000000000000000000000000000000000000000000000000000000
000000000000000000000000001111000000000000000000000000000000
000000000000000000000000111111000000000000000000000000000000
000000000000000000000000101111000000000000000000000000000000
000000000000000000000000000111000000000010000000000000000000
000000000000000000000000000011100000000111100000000000000000
000000000000000000000000000001110000000111100000000000000000
000000000000000000100000000000111000001111110000000000000000
000000000000000000000000000000111111011111100000000000000000
000000000000000000111000000000011111111110100000000000000000
000000000000000000001100000000001111111110000000000000000000
000000000000001000001111100000001111111000000000000000000000
000000000000001100000111110000001111100000000000000000000000
000000000000001100000111110000000110000000000000000000000000
000000000000011110000111110000000000000000000000000000000000
000000000000001100000111100000000000000000000000000000000000
000000000001100000000111000000000000000010000000000000000000
000000000011000000001111000000000000000111100000000000000000
000000000111110000011111000000000000000011110000000000000000
000000000011111111111111100000000000000001111010101000000000
000000000011111111111111110000000000000000111111111100000000
000000000001111111111111110000000100000000011111111000000000
000000000011111100000111111000011111000000001111100000000000
000000000001110000000001110000011111000000000111000000000000
000000000011100000000001110000111111100000000111000000000000
000000000011000000000000010000111111110000001111100000000000
000000000011000000000000011001111111111000011111100000000000
000000000011100000000000011111111111111100111111110000000000
000000000001110000000000011111111111111111111111110000000000
000000000001111000000000001111111111111111111110000000000000
000000000000111101011100000100000001110000000000000000000000
000000000000111111111100000000000000000000000000000000000000
000000000000011111111100000000000000000000000000000000000000
000000000000001111111100000000000000000000000000000000000000
000000000000001111111110000000000000000000000000000000000000
000000000000000000011111000000011101000000000000000000000000
000000000000000000001111100001111111000000000000000000000000
000000000000000000001111100001111110000000000000000000000000
000000000000000000000111100011111110000000000000000000000000
000000000000000000000010000001111000000000000000000000000000
000000000000000000000000000001111100000000000000000000000000
000000000000000000000000000000111100000000000000000000000000
000000000000000000000000000000011110000000000000000000000000
000000000000000000000000000000000110000000000000000000000000
000000000000000000000000000000000000000000000000000000000000
000000000000000000000000000000000000000000000000000000000000