
000000000000000000000000000000000000000000000000000000000000
000000000000000000000000000000000000000000000000000000000000
000000000000000000000000000000000000000000000000000000000000
000000000000000000000000000000000000000000000000000000000000
000000000000000000000000000000000000000000000000000000000000
000000000000000000000000000000000000000000000000000000000000
000000000000000000000000000000000000000000000000000000000000
000000000000000000000000000111110000000000000000000000000000
000000000000000000000000001111111000000000000000000000000000
000000000000000000000000000111110000000010000000000000000000
000000000000000000000000000001110000000111000000000000000000
000000000000000000000000000000100000001111100000000000000000
000000000000000000000000000000000000011111110000000000000000
000000000000000000011100000000001111111111111000000000000000
000000000000000000011111000000000111111000001000000000000000
000000000000000000011111100000001111100000000000000000000000
000000000000000000001111100000001111000000000000000000000000
000000000000000000001111100000001100000000000000000000000000
000000000000001000001111000000000000000000000000000000000000
000000000000011100001111000000000000000111100000000000000000
000000000000011100011110000000000000001111110000000000000000
000000000001111111011110000000000000001111110000000000000000
000000000001111111111110000000000000000111111000000000000000
000000000011111111111110000000000000000001111111100000000000
000000000011111111111111000011110000000001111111110000000000
000000000111111111111111111111111000000000011111100000000000
000000000000000000000111111111111100000000011111100000000000
000000000000000000000011111101111110000000001111000000000000
000000000000000000000011110001111111000000001110000000000000
000000000000000000000011110000111111100000001111000000000000
000000000000000000000011100000111111110000011111010000000000
000000000011000000000011111000111111111000111111110000000000
000000000011110000000001111010100011111111111111110000000000
000000000001111000000000111110000001111111111111110000000000
000000000001111100000000001000000001111100111111100000000000
000000000000111110000000000000000001111000001111000000000000
000000000000011111100000000000000001110000000000000000000000
000000000000000111111000000000000011100000000000000000000000
000000000000000111111100000000000000000000000000000000000000
000000000000000011111110000000000000000000000000000000000000
000000000000000011111111111111110000000000000000000000000000
000000000000000011101111111111110000000000000000000000000000
000000000000000000001111111111110000011100000000000000000000
000000000000000000000111100011110000011000000000000000000000
000000000000000000000010000001110000111000000000000000000000
000000000000000000000000000001111001110000000000000000000000
000000000000000000000000000000111111110000000000000000000000
000000000000000000000000000000111111100000000000000000000000
000000000000000000000000000000001110000000000000000000000000
000000000000000000000000000000000000000000000000000000000000
000000000000000000000000000000000000000000000000000000000000