
000000000000000000000000000000000000000000000000000000000000
000000000000000000000000000000000000000000000000000000000000
000000000000000000000000000000000000000000000000000000000000
000000000000000000000000000000000000000000000000000000000000
000000000000000000000000000000000000000000000000000000000000
000000000000000000000000000000000000000000000000000000000000
000000000000000000000000000000000000000000000000000000000000
000000000000000000000000000000000000000000000000000000000000
000000000000000000000000000000000000000000000000000000000000
000000000000000000000000000000000000001100000000000000000000
000000000000000000000000000000000000011100000000000000000000
000000000000000000000000000000000000011100000000000000000000
000000000000000000110000000000011000111000000000000000000000
000000000000000001111100000000011111111000000000000000000000
000000000000000011111100000000011111111000000000000000000000
000000000000001111111111100000001111111000000000000000000000
000000000000001111111111110000001111111000000000000000000000
000000000000000100011111100000000111111100000000000000000000
000000000000000000001111100000000001111110000000000000000000
000000000000000000000111000000000000001111000000000000000000
000000000001000000000000000000000000000111100000000000000000
000000000011100000000000000000000000000111110100000000000000
000000000011110000000000001111000000000011111111000000000000
000000000111111000000000111111100000000001111111000000000000
000000000011111110000000111111110000000000011111000000000000
000000000011111111111111111111111000000000011110000000000000
000000000001111111111111111100111110000000001110000000000000
000000000000111111111111111000001110000000001110000000000000
000000000000011111100111111000001111000000001110000000000000
000000000000001110000011111100000011000000111110000000000000
000000000000000000000000111100000011000000111100000000000000
000000000000000000000000011110000011100011111100000000000000
000000000000000000000000001110000011111011111000000000000000
000000000000000000000000000111100011111011111000000000000000
000000000000000000011000000111101111110001110000000000000000
000000000000000000011000000111111111100000110000000000000000
000000000000000001110000000111111111000000110000000000000000
000000000000000001000000001111111111000001110000000000000000
000000000000000111000000011111111111100011100000000000000000
000000000000001110000000111111111111111111000000000000000000
000000000000001110000001111111110011111100000000000000000000
000000000000001110000001111111100001111000000000000000000000
000000000000000100000101000111100000100000000000000000000000
000000000000000000010100000011100000000000000000000000000000
000000000000000000011100000011100000000000000000000000000000
000000000000000000000000000011100000000000000000000000000000
000000000000000000000000000011100000000000000000000000000000
000000000000000000000000000111100000000000000000000000000000
000000000000000000000000000011000000000000000000000000000000
000000000000000000000000000000000000000000000000000000000000
000000000000000000000000000000000000000000000000000000000000